$ANSIBLE_VAULT;1.1;AES256
66306234626536386365386461363964366265623232336432623534363564626233336638373163
6161376639623431383563613439336635336361303331620a363461663861343335646238613534
39363466623634333963303535336164396636373466386363306134363033653436656533653833
6166303138323937360a323362626266343266343134356666306364393163653839666262613266
31313235323530326634656163306265633666316564376264666563623161626635343337383032
36616139333665626636363065333935663738633637376334386164633836336430366631346138
30353836316132633365633161373634626638376334613438343630343637326162613362313265
32643763613638663361383739306161363531303935346336653966393230613930636231306635
34643866393934333931653961373563313335653538666536663434353861613131333339303666
36633139663866643030653666386636323666373837666434616363393135303132313432383439
62643963373833623963396634366665353463376533323866373465633038626164613464613563
61653939323435643865353861646233623834376138656533333962393666316131613330636265
61353065313263613538613034353631373933623666313734666133343961336135366663356137
35306339356130376561306661303536363731373765633135663439326265313965353738626462
303334636437316466373638303833386266
