$ANSIBLE_VAULT;1.1;AES256
63356565613331663838303966366430303761303635346135616635323330373132303935343765
6363626634663838303338653137313666333431613732620a386363376164316639343637396136
34623566616133356331316636346237316665343338323234623666313663323230393738656437
6263636163373636620a356535656366666636393863363938333564356331326163363533656137
35386435353364366131336436346436653565356661613637653964623737336632646264313231
36616431646465363362623766313539616233356635306632383335373636373265373735653733
35363164333964663639633734353865313465386639663733653433613866356130663933346534
33346366323033656366303663316365363963323738346637373061663261653138313264323966
34333137326163323139386330613664616533616666343564366333623530626237326363306566
66393562396332363264653431393263336361383635353864346666396633303035633264363337
30633533613465313738316231613032616638306134373432616263323466666663316138393863
36643735343661373933646132383831653037383138646661653735343632303666633037643139
33656434616163656331396134313962656637613065333835643437663436316337326230646533
66333034346531613166653433656332343961623731303865653732313565623463313434346436
37643366653636613639623463643035613936306461336630376666333136336437643765386533
63323436636135373932343636326330316335313639353033663533363834663938366432616263
66626461343132333364643061616130616466613865663035336466333562356437373965386332
39336165356565376236346639613739346635313462393230646535366432373430333364653064
32343536396132376361643162326565393663613432656264393466313833323361313064643130
38623266336332333134326633666432313964363233633963356561363362303863376463386165
64343335633262313131323462303934383161653031376238613264363036363334376337396137
62653537326537626235613165393832636166386130333062396632613366363330643532366164
64636535373238653466303431636162353765363430643134323531336338366135666535623130
66623732613232376563613762663237333766353066653534323363346535383833636634663837
31303934363238316537346564303237393638366462396234383136353138373939313733303966
33336237623033633863343038303865356431666537656237383162313337333761383633636266
39653838313632303337616437613364653139353062386238313635633633353939343030393665
36666364363331313436393061633663656461616238306261326234393336663438393836666164
61663863643661656163356137343662383965613464313536623939336336306462383930396661
30656437383061383637376539326538393461623638376436653932613136343463613939326430
62373930393235333230663130633261383536383836656635306664636632663830343934323237
63613466643138616462303232636130316264353261616433633961613263343964376563663133
37333861663636386232373830323435336330336636366636663364616662343062623730636236
64636463393931636265626261643336393130323935373264623738636566373033316133373535
38393535636564343534613063646565373566366365326261356232383230636363366338306662
66313061653637623564623463613064626434393531353538643661316662333361373534393963
34613334376533636263333666656664626263366138356437306462623765373663616331626463
62336636323139623730343163363763363266333962613935663938626464663334343561326434
62353736633638663633306263623030373638376564386362646437666234326130656664346639
38656536323665643739383665636533333537393535356535323935363062383662383665353038
63326531313738646162633331373366356664373230393362373765353638303631366363623066
34373633353464333235363438333430643865653161643837373931333937396236333432653435
32336139653339643764643130643036636434616134323932343062646262393835386333313866
35636336363637396539336432626239646237363062646265363735613233346132633531613834
38336264323565376262363266356262666436376361303236353864633336346166303461353539
61393937643235363933626337643931643765646566393262613361376433326632326234356262
63613035356364383636373262333263663539656134356337353738303633666362636463316662
37653731373933646438633634643866306265326430373861363461333931343465353630386339
33316330303131666133396365626363323831313436333039623132366165636331386436393565
63393262663735336435393438373634313632303239623932623939373838346666646332383039
39386336316465636332316663383463383663633761306566643739353734366633383835316164
64643664656564326161343366626362336462386437363532373938373631343334336461316562
66346236623664346365656639383535373364313830663235346639383633323434656636316464
39646430333239326633346364316366386262623561666532343435636439643962613162643431
39613837323333316231366265636535386164383862613833363664396534326265643232656134
64323036383335346430656633366433353239653332343934653030343837623830353361373730
62653333313562633037666265356433653766623037383565653038366239636266633161353038
39376163626238623236646161643638653733376331333136353065323339363231636238333132
38323835663635356333373165613666653430376666643230356133343861333238373635616339
36333733663831623061323730323765313033353632346164636565373563336531623865626561
61323435656135656361323936343534363864323461386631643338323636333635356232303831
35373861326337666239656536613637333066383231313430353332306565633231356338313935
30383066653237636131323833393838343965376233633431666461626166616136396636373062
65656331396631633831653362306464326266636564656665326231633135336661373165363332
39376131376365333763353662313532346466353865393234363930666339613262303761323431
30666134346562303632336164333365363661663661356630636462333161303334303331313966
62383066363964356231336138303339303636333438363934633638353166653765343230313463
64323238376430666239353439316163316361323539373639373339363338653930623666653731
31623038306138363031613461333961383930646634346364303831363339616365656563633833
33653737646332356363306339343466393232313136626135303566656363346633616632366262
31616636633137386234356131323463333139346531313361636239396135653735613330633762
33306339363064333539346666623863353464393535346137653031326262646532613863393136
66373061363065396562316438353538336164373830333465313731336161646164666333363862
66616637373537353538376334316163343263616533383032323964313030306263366164376537
30356666366638626633643432326233386230313738333230616230306164316163393734643731
30346337666334313561653564323939336137396264613939363666383137663065316235336362
30623361343431323164656236646234613161326462303964633139323437356437383631396566
36366661393663313662353733316632346239343934616661316662373830656332393963633237
38633462303832366264623062616364643838616465343961386363653030653739306661383264
37313732343461313432613334303831356664323837613466653533313062333436323265333462
35643764653531663234336138363831326331323531323039636263303832643461303330336135
66636531336566303462363038323832383732653136303137363736356235613734383437363163
34303934313130376161343036343534313963313638353864656462323863626537383337663165
39396636313261303136633637333638316366363535616136393338623733346637353438643434
30346138303337626163386230336161653235383765636335353663346236616239306531316263
66656135653035623234663662383061636136616138363466393635393736663565383462316332
38303632366364616130356331386538356565386336396137333936373833643833643366393135
63313035316133383366633438306361376565313163323438356636353732613035383336613631
62383161356637376135633033626536326336666437303533303936353533363039363437316337
35633536396531396265613937366330383630313730623566613363373362306639316639663862
35386663363763643039313338353137363930333935376262613763316138636636313036613633
63353533383764613863366161353236393131383339653139613062643665393239306665623330
33383161613534653237336465663837336437643362393630633931353361633933386139363531
65653338663536396339393536643333326335323135623638346632323065613966306338363662
30613062623735393832646365356366666139353333376562636135656562346361643361396636
66623333656533353331323362396163336634646333303738656238363866306331636331326334
64386136636439616631376131616661326164363538363262643833643262633432343032363066
61306661363236306565653163653538326630613166396464393965316234353032333462383633
36393934393137383432343136363038323733313063306334363635343566636162386366633439
39373832613734326537363731653766656234326334316433323861306363356430393030666264
32333334623165656435626663393466636662316530633132313361386564303964636161366233
34363564343766646561616139643339613237643137376233303233353861333765623033623961
38326331623435616233633539666664393331633564346531376432623463346638663932303733
32383165653036383431646361393037636332656465396232383833363731626563613130333636
39646531646236363162383735633564353165303264343764303337393661616364353666313135
38656432356462323637653634663531303164386261376332393966613038633530346636633564
63353432343430613765663434643665336432333530326335363463353035313864323230356563
63343262373062346535363139633736343464653439333237393737663230623338643335313035
63313532303931613035323561306265303266636236353430396461373334663333626337643866
65353565343832636330373031363732393132336264343037336265316563653265393933363031
38613531653839313261396437376631646530356464633734613533383931623833316233343163
39623337666266303532623036633934653439643561343331363066626334636161383161616430
63653361633737363634623536353961323730336465393764616265386330363634376266316666
32373934633934376334386239386439656163656431626262313864646131323536343837363531
36363662343462373534303662633537663838313562363966616631383935343037623638386137
63303235346331633866393465396333636438666639623730386337663064626563623761656333
66326131333630613336646465396563613266316637333836326331623232373230363664383463
36643164316563366239316562613735636438396435363931356636363366663735633534323161
65363634363265663930633839363634626336633132333733326362373663303736383866653863
62363330323464653232383535386530646362653834313530343235353663313034336433653166
31313837373538323236323536303964316462663466343965393563383939373639366432366465
64303165363939646166633763633063366566393332393938396634373465386166306438323536
36343831313630636532613133633662323065386164656266313434636336636536626263366566
65633031356330343162666264313531313434376662336330366231336338303832386335383566
31323031656134636634316365346536303530316533323565336535653366343531663734346235
33373066336238623330643363666164626432333936316531653337313635386366663661393834
36646164393339373661393463383566663937366532363338633833366139356233356364363435
32313364326164376338633161386464316665393730626364663238356166356564373830653638
64333131306333353262343265633362633630333437633165613530323633613063316133326362
65336230643462303734363536653032633639316437306333336530383035303633383036373830
39313137313061653064393136653439666238666331633762383636323831356339333230613637
33376661313231376535376562386334613034353031653961643166333131316164393439666364
63373736623162616639376234663835333438376461353736386231343661363532383263366635
33383036666264303433626165376361313233336666323063306436346366613537343331613834
36663061663762636562373737643538643064343230333730633532326235346439613162356439
62643938343737656364663965653734373461303034303964356637343331323536356664303361
66326130353766376439666464666338373466656262356239313837383632356634383165313038
34303661313335373562656337633563313936393637343363353663353465633164613234303838
33353337313162633730643662373936666662623632643163346437623437653132393864303232
65323262333838303538663930363639346332306339393537643636343261633431643666623033
66336463373261666464363137653164363834306135393935626233633937356562326362613666
66613933623237353862353165636662396533343433343139663631393131356466306262653036
64643766353639343961646661353233636665663961346533353065653430623064326264376531
64303935363235333937616236653639323366626137653630636565333035356461643261636366
61373661363931356430616630613164336234366236303938336461326363303031653932356235
64646162353137613839363435656335343165323135633663393739333365616636343335373235
34306661336134346265636635356336653131663734663966616434383838383065323435653436
61376432653164646533363336366664383065303734316339666564663338663266613936613730
66343139633039303434623839363730353133303038313338663066376436333635643935353562
32366134623166383838316539626435653635303865353335373135353139663338396138633639
31333761656130356535326639386239353662373533343333373238393935316465623039346635
35353966636566366633303536306130363239313666656231333232323665636335373166636530
61386635633636336532363966663237623162386166653438353137636339616632336564313265
32383333633561366331363662396231333963336238363166383063653065326666393332323231
33323066633337363330663034393461616664373361336364393664326536656538326439663634
36326635373663363734636161333739366265333236653636346165643039366334633734633738
63656134653435646434666162373731306534376432343033656231613564366330616334623539
35663765653534616537656139326637303835643163623733656666656561663239386530393233
63323831383565313663306235646435303432373839353632663163323632643632623234346532
66373139386534343737616236326535623266616636653565353131613339333930383334303531
66373835356432343230643235343964343538613034653239623030383666323237643265356633
35343963323734626532376238616666663935653839613238326564366161343333356533363064
38633764303831633065336334636665643833346265613965643530303764323966363238626364
62393036343562643664353531613363353039313963626564386631643662636633313738323062
61313735306264333235343732643533653837633031653734306132356337333134646163386636
63353864336462323839613933353336643539303232376236346630346161393433653130653162
65633531636330373132326439393631333438666162633265353531666431373836303262343734
63623930393765316561336133646364663735346432343731626433636334373861386438353232
33313836383835663136653861626364613334333061306239316430323933386332383934353835
62346332666330373039653433326630333762326362623630326131666463373061343137343336
66303737646238366336623330303731613431616432313562376132373435663937316237363561
37343135303063353463313039633837633836386461643335363164313636316232316331656462
34346430376664373863643365666138613961636230636264653735363136363135343138616336
37393030646139323763666162396230326639623266333237396238633962313439393139633762
63303964346263323535343334373632336465633937376333663530373632393333386130366135
33623234663163613336613663336666346235323763356335353537346639626333353239623131
65636436303864363636316365393062623837333061353633653930353736356438633661616137
32653435393264336164633265316237363930323761396238306531333962656636306432373132
65353736386537383966663332653038646539636432383033666630646532333035336162643231
34313038343265313339386461316230333962616665646165386430333864303765393464353735
36633964373762336162626636316635316637343136326237343062353234326363666135393933
35663431623564613838613861373661316166623230303334616537376632363633303535366339
62303563616463343262366437303962373035353939613337613931333463633033623665373561
37366536333139323234363234326163376462663466336232373765366635336166303138663361
31643162613865613335343561623135343535663062323364333062316432323236623935373435
30356664636335353039393763303331383939656230626138383032643566623562353032633838
30613238383061646362383366643837616431656237656536376465313065393666626563353237
39646266636434373938316362386166353863653437326432663466653533386239336465363934
39653035656438393366663662346664656130653764656163353161653564323538383834326132
64386465643335623730656361663739616463303261613630633233316336646566316238653163
33363562316335333765343030626231383430663236663562323032363430303663383230616530
35343266323936396232633131623961643364316532653235633561396632623963396662376233
33363035636464633432313161343763313930653730656261396661356536303432393738336662
65363464303062363764383037353164663166326533373164646231316631333532383938663161
61353330663833376332663666303234363531366437616435653330313231303238306430373331
66656635353338383063616365336238306365663130326562633961393031613635316135303562
36383237353962303462303230336165373934643036626365333434313737633935346365653131
61613864623261333533336665346339363334336261336334666461616131343237383732643539
61313732353032643161653566623663656165306533313131626462363339383132313832623937
65663062643238623866633733383732306663383137653261336262646363376439373238303862
31353331363362313065343536616666393366656438356631633239313765613535656531636136
30386330383761363132653335663038323831636436363066303364616634376631316137363135
62336138656530363361656137616536316466356639633566393838653363333963646162373461
62323836383564343933306232353936363837353938343731623136383137373838396266333165
35323465303430633763613364326663393862666234386663376635373765613632303236303736
64653464646230613335666130626130663236366665363662303432663531616234656237343362
39356266366430313337646365316264333563346438343063646133306334613366626437326436
64326534346563643366653631616238363734373766626337303933343463353831373630356338
33623362316436333631613536363139333631663232663939326130643530633262303361343763
34343331396532613535356130303333336263393731373166643963316266363261376533636136
61343134366465306361356137316230366466613063303330386430386536636462323638356332
66386265613433643164353537346562363435653536306361636432623131356639303964383462
39303932376335346132373331383664353766663665393731616163383261343161386630346639
32663531356432643232626230623362366639323862643831333064386135613835303732346634
33303037393930333464646561623937626437326138343831656161646364383731343366383762
38666433346337323031303566646535383363313434633937393461303463663832636366323036
33643232616639343862353337626261353764323061333333373630646432396261336137626138
35326636323139316164393532313530653739613531633264346562626337396130323561646533
63386435323435626434373933323265313236353064323363323033663961383062356635363836
65386131373432386461643837336364643262326437323137636262633066633530653136396363
38633665643737333634346361666232633331396537323764313632346232306132376163363735
34383866366532306264613161643030313461383234646632346538653162323932356536666531
65306463653366393765393065633765336366323666663930376630323437633166303031656236
33353737333930653437343066643135346239376631666665333962323836363461336566333739
33336365323761636130383932373432663966333037666564636237376137333037363466353036
35646539663362396430343834393631393264356438613461636638333864333130346138633865
65396633333836336164643761336261666238373263623765353063616166396330316438336634
38323738396533663661336336383134623263363937623061343831393239393532373264666536
38643333346664653066333833353930346330333138346630313764363632393732663436376335
34666238303932613839313137333831366332613765643438343336653939333036363763303639
33303932623962376166343266666238363934346539663038376634396335663639323032613233
63396630376663326539316139363835303039656531343464333663323631343363633061383261
63653637303262336430616361626264343237366661346664376432616434666366666534373239
31376636316138363032636332343461363433303361343364346262653161333462646566663664
30376661383464613532356631386632303230383635643239323134623730656363646563363638
39383839626633636437396632303931336632616331623733663031383236373865393565306565
64363039346562613534386332613036396432633134386639613030353764373239393562356131
37313836373131653862623263336663306238313937386266346234313238663132326162383637
32396465613565363632353966633066616364643564363231623231613332626563366337373362
63306264353861323430316363343234386334343338333864393066646632623037653264363833
63323962333366633639333136623938323163396564353663653866323637636430346335363036
65363932336561393631383861613536333731653235376336353936653139366561626238343236
35393833333862343933303834633764303235326536636438366339313331333532396639353166
39323635373561343066373632633965653133623964393963373537323961613866613132623762
61386164363566353734373436303961663132616431373839356137343135663562373038393738
37313834346135343162353138336631316264333837623962313131316263376164616333323461
61616466326631616531326135663061626233323866613163633464633663313331346266363161
34666332346336353933623735373032393033633330346138373233623061333032666164616531
30366437353162363737313561333366623264343438663132626434376634346164383962363763
33633763643432666266616538653138636266353431353165646162663566633863343766366361
66326332393730343937353139326638373334383734336664303761613361353965323331303133
33643663643666363332616362343261663361623935653334626662643964363231353965653235
30643838353035313631613534376634623662623662373261633266363536663536663433303965
64326332316234386136326262353537616230303837363564396535623531623733616133303635
30383231616337376534623437333761366538383636356435333934643932643863353565646262
36326531323631653539323565636530313961636664343036363633306466646133363266353066
63646239366364376232616239366338316633386634346230623563313033323465313437306463
31353834623230353330393838353665663162393665616463313038356566393738343035376662
37663764636130396233626634313836313337663464306438396437326164393662366539376533
34313336663161653136666238343234386364663432386361636134623038323065346161386232
33376363383964303962316263643062376666623130323662353533616466616635656566623361
32303031356238646335656631373561313938353166613263373161333131373735386361396435
35636163353930633934363336323165633061666135353061306131653533343761636337333163
35636436656564353365613735616431373830323464383336373835376438356132356630373665
62353636323263633837616636383231306436303935303162663934623964626461633766363666
64653038663637636231626534633663643933303338646665373264663564383535616366666538
66666466666263666331393139323362303634633731386439383731343664343138313239326433
34333562303233303138653836633333313164306334323634316163323930336238383464386664
32353033336261333063633532333635623030653637353733646337633161616630303365386139
34366365313164636537326265306135613461666633316437376239383063393532326362393834
38343233356635303363333732363664323439393432333039663864323533353938373963623439
39316137633163343464336363383732303535613261646532363438333366633539646632396362
36663238383238666130623235373566636462373136326531646231353666333865366561656165
31623561363935306665663263383939323362393166643035373638363031326436333237643061
62663264356263363930373239366535643864643763646631346238303362626131333833643538
39613765333163313466633730653833623566636631396235393936346532303333343833316463
64393166366431373430316561393366366533376439323066346464636464653232313165613361
37313733373064396439386636643833366134616238336236623930333731346136303864343261
39313165333563653632353131303030326536643837616333393662616531383562623462316131
39653331663266333337363539383764386530626430653164376334653737343533623235353764
66386233383664616265306638643266363939333661356162656537396662643432346663623334
65336233633364303466396663363562353434656662383762633865613365346265396334366631
35346639626635386637356635623833653664343965373038623965396562633663653132393664
37623631326665386230623330373938623134633561613437366139623463613763643930643166
35643263616637306530383963353738623061656666623738333363376631333339376363373639
32353164613530616639626664363762383161653864333266623435323932633665343266666432
61306337616539663133623163306534386133633631636534313862306265353937616634626238
30393363383461653365386235326131313362663336323366646562346132616165363935643461
34616230303432366563396561313339303537353665313461366435333264306163326339373531
32626632613066646265356561653866356533353665636439646562353065393933383737326536
62333634636466336263613939366564306439376532616237363438636239343462333336623533
38373731393932343036646435313730656533323632633835663835393065393430666435386335
32393535643335323365373432313664313733343836666565373164396136303439313738643162
35636132386661303035396237366131396531633032656433646634613764663838643862306161
30333237306534336431326533613130306239306135353935313832323938343765386339663834
31303836373362656131613661643333646230353933646262343661666466343763663638386264
62633732393930623861303731666636643464653665343363363737613233363933643463313438
32346331383066373165353131356436623464326165396431386234613062396331663235363538
65616234616262643163393365636235616436353637663231363966383334323863323262323932
33613834643763353861316138326636373633313236353133393061626131353137626663383966
36313735313536643031373661656265316136646565623831323837643864313536326566383437
37363539313861386464316631643030333962636265323736333166306565343133353263316166
61306238646663323466616233323262656236303762643937616539636230303835373732643738
39396362633538613336346565323731653532383531313561383465323236316665393861306435
34393531356535336563333138316138393436313130356633383535373365333033376138343835
63393965656664633135613734656130623261663330633036343731333163613731306662613863
33656536383065363236383635653963383864613136356232613130623436383161343439383238
61323062373539666263303431386166636231613535623039636531346564373131616466363566
31333831616261616330353834313066646133393339376163623337346639336361663139663961
32333839326239363736376436623434373862663136396539333833623733353438343635336431
31313863383433623139366634323735393863366630356135623064633439666562626338323432
34393964656366353933393336666137316530616431653363393861643266303631376433656231
30323263383539343761323335313931393231393633386630623730376236643663326635383339
38303731353866383938643933656134346466643663626163303766393434353330656536656537
38333531613164373533653063653238323064623733336232323636656463343139643338633737
63383462396433323333323265396661333533626436356539623538363031333531376637363037
31633566346232623365663461623737366638613034653066373936623037616331373335393834
39616664646434396439653763316436613932333264646334343637616437353830396230343666
63376439303239646165373439316638326163376137346232393965366336386639623930393564
35616465323134366562346561363335376431333862303530656362333630383064643439343261
36663263323962613533653666303935636334356639333762326431623930623765356132613037
35623862393031323065356664623961643566633639326634383830616266666362326231343263
30363535336633326563636231643630303132346634313739323630666136623936383438633632
64666438333632376566646431646530656635626234303531333933623338663861336532333733
61303934376230646562306664626335303164343635313431333264613131383038356338373339
64613436653662656130623238393637616338323466306566623031383731376536363730666332
31383861383239303664306131613635626161353962396365323939616263343063343835623136
34346565316463366135376365376561306166373261343766653466366364646461666635373665
63323738653638613633313039316635363961626535323364306438633032346266313432616639
65346136393432336562366633363133386362333035323135653539396362343231316662366162
34313662386537616539666365356263323164653336613661346166383164623962373438313863
31663835653762373266663236386637356166333332323932633663386231376163643366336661
34363263303565623832616162306439393731353337646134386636313862366466313137353837
63633963623130653432303462663663393062653438343062353934356139333565333830643637
36343965616234633462316437376431633931303132373334336664333266343062383631623135
35343661306662633039313833363934616265613566653465323130393638363836646234323135
34633438393337376138316236623164393366663435313934353432646532383733366139623739
6136613463656339343132623634396636633830336262636334
