$ANSIBLE_VAULT;1.1;AES256
61313737666539623333386562356335376162643463343933626166373536636664356132323234
6336616531373966373361323034356664346132643336370a326466326466336230383239356439
61366335313838643364333134343130666665326434386339326139323332353963393564373030
3332396438393537610a656461653563633134323963313237383238376630366638643239353132
35363438383063353764386338313637666633383232376565626265386132663836346237333363
35633736366465373261316533366135643638663161303730316664333166623330643934303639
38343734646432376132626262383836653830346139363861373632346537313635303330653539
39306461306638643461323736656462653135666461626139376432353363663665633862353737
61376362323664376333663439356162663537346131313065633438623830343064316636613231
32633939373636643061623666396530353665386561613634633835616565346661626563386566
39626432353531633063356165303533653030313034623061346138376234313161643131393638
62316539356561353130633633613464666535356638616165323263616230633262346635383138
62343630613231383930646434386161346665346634633536663165323337383865393830613330
37346436386663396362363963393362393735636339363935376630396638643533373034613633
35303236343833626533363062343337383461366233393966343963643632353761313434646361
39643637633237373638653233363132663939336637613530313338373132373434633732636163
65393163323363343839616136326536613338643035353834386161336530643639303361306565
33376564376139646638666362613961386338633634363134323733653831626435313133333136
37616535376233646334663264373164666265356230343136386165373937626534326237376364
37306561623262313036616332623731366632343138343364666561373163646634313437633462
66626166663233613930623334343864633533636530393535636136633565333365653830646530
65303436373736613336366139386534313333346461376531626333306433343965303936313437
34383038633866376135323164636237373361313130663331363134373531386538383962383235
31613038363065633130613338316137393534663666303863356430636633656631663339353562
38333865613336316635633430393338633362383139323263353866343163353736303463396334
37303234666561316461353333363730396161653732366262383533346666623961343434343132
66353736373338643631643832623230303432346636373834316230666531353634353134613030
37363463346561653538323361383539356632663530623864316564396135343038363232353161
37336237666336303463303065333436623133663631633966653061313965353161643534363164
61623939323332616536343863333762333664396161373138666638346636343534636431323737
64663561636636633761626265643935313530393065376139333265623566386564343066613631
63366266623064356133373566326631316164363934363932363664373464663835663538656265
65363838336535366637643335643065353536336235656336333838393466643262366434373065
33633931393562306462363635386363613961366235626638346237623962383662363561663537
64636563316135636564613436343164363332613464326236303831373639613630343432383163
33303662656465346662346132306637633138613032396535626336353438326639626636383066
36623930373063346635363664316439393434666431363762373865633230396630663331316131
36326337353133386561323937646163656530373936613165656265303736376639356236633637
30333862323137326136396164633839623432383038643032613636623831373464623431326463
39646163623734393832363461333132333334323137326233333463613633656162303634373961
38646563643134376261343065633932343962323761313461353063386537376530643435376433
64363963316235633630363738656162323133343932383965346362326461303461656132346136
38346665663463613239336361663733386237653564613334316561313166623761643965613033
32306333396532636437353562363232653831656363363665303765616533336234663937613030
65616662616561643136623461333233313963323264636637633862323864393765616535336535
63626337316433393532306338326361646337653237653463656331616165303136353038333230
63313335393836616634626134386233346165366230326366323531663362626534646532346663
35616463646130623939316539383231643365653535323565643631646433393537313530613430
37373163306333396537616536343731313831386337383963666132646336306537303138613530
35353538663461653461373738316165386433643830643065613166616336376164373430363432
33356431393730383939336133353737306665366637613039373164666332303639396132646535
61653263646539303930373665326232633462643437366332643431393634313034373166643131
39326333663662616265633333383931623439396233626566366234376361323737393164353461
34396136383238306637323531343066376131333335363131663432306432336464616436333737
33346162613732383339623662313832326536616435343536663231326164323132353164333031
35323062313136346465633564643961353632636464343262663662346539383264343134323730
39313631383466323961346264653863346665616364323537646465313936393635643661653561
37616237323235343930303238653963363931303064356166393031316431356566396664643432
31333965303661313439393035643133643830633664343033383131363166356266613336353135
63643463363736343130336233636261663934643562363431373930323661636334653238643661
39336232303264393730616537303330393635373562323638356466653832653737313235333436
62613234333965636235343839393539373661653632353637363965616237643761363431653963
34376437303338396164313766623432336435343130656564356632313265306462663838386363
63386430656138343961343139313165333265656630636339346361336137393732316465633666
37366461336665313736313833373338663237623436613636363863613836386236326436633538
31613465313033633962313263643135666562373964353636613930303931323865386537396164
34653761383036303464343232353836346266633761333865663937353133653038633534316635
35363763393733303235333661623035623638313863653235383231303362353737346565396661
33346235626335316162353432353830393931616666333731333562303133313161633030323938
38343966343664303834633330393039383064373837383138636333376635336137396462613834
65663931393730656565323439626434343466336134663663386139343462313164633730353130
34343635353531343133353862663738346163363338336536353165643839616133656630303937
30623264653233666632646661663834393232623830303662333236353730323765336637383564
61623266383666316239303039643334363866383066616564383636613130323565343730633534
31386661356338623430353062623866663362383564366563373861643132313564616562333636
66373566333361616161623766323731303662316565393862636137383739353264613865376334
38323064343865393966353530393332303865336163396137636136343439613563323266633739
34323765346335356463346463386235393939313462613037323661323262626661336662643333
62653236323862343438386362363638396530346336343063393661663064643538363235326533
33306666373836616434366130646639393064333138363434636562663736613861313063336431
35316464396438336364653735396435376432623464323030313730616531636364306336343663
63656563333362313363383539643562376332303761323534393066326164353632633932353836
66666632306364613434623232373739393534303861306635616336333934616434396633346236
66303638356334646166356462313031373363623335373737323665313665373936393262663366
31623333376363653032656232326235313930356366636335383230356265666364316430326231
31396334303633633463316638373061343833663032313632353631336263653963346462343863
33316165383035386134663439396665323166666438303463363432333462653137313539373633
36353639633965313938333031383865373665663739333030316632613339656434336432393933
38396461303166656331313762656566623135376434386237383536306165373735336634373930
33323261316332396535333732626563636332353836396638356265343736316564393430626639
37626138643761376636336430613162663637383163343332313331393731626465623061616133
32306334316536303437353530366631633736656635663566666665363065623933383237663963
66386465353539663339353665646633376334646566633165643861373162353932383534666565
31653131623037626663643736376333356164373931623837633837373761653364623234383131
62633331326635623331616164623663656230663230336137636230656366376165306635343735
64386637623833323736383037623332613164633731303662363061306665613935653534633938
30336134663861326663653331636534333139303235653935396264653261333731373231613433
36386530646463313834366334333538663232626662376232626362653238383364303335353136
34643633626539666565373362633266313138663730363235663465663837393733303436383734
37393864616165656464636364613435626239323335653964343230643532613063343830613635
35626137613033636363613033366361376333326562666262343035633734323336643163366461
66383131333536613930326132393333323562366632343166396630663532336266306231343461
33653934616233326436376163353332616439373037373666323566366535393961333861343761
65386430303365326361623166356230313435366462393735313135666336326239303639363230
39386335313339616463616336653365613765383539363265376463306633373562323661643363
65366562623963346465633265626562613639376431663763333063636130356461363131333765
35663830356135623233643763313735303732366463383966313831303265633136366561626534
33373538323534333035326662663665613931626631303235336334373238393434643536363739
32353233666530306437363730353764613835353933613566653961356632333663613134646366
36343166633765316635373137343265633232393762323363346262376536616665613330373737
36356232323332356661633137353066643733333937396537613337333134323137643535356530
30333331393562333236393930323363623232336436313034376434653764333931393134303530
31653266313063363437643531663865636161313032353266306663366637623732303865393166
32306332633433616138373233313765386438343735353966346639333263646137663231373166
64393535316265383237393830646562376330626539373331313337346462623639613338643735
30336632353461616630376230336433653935386662363166653832343866343432316434613139
66616230343864633031616366633437633233393664363666316661646133386462613035336533
63373834376637666537666537666161343034313737366537633034333438636663363532396361
31613135373236623533346130346263343538346433643939613930386530666531663439623730
36656437383766313638366132393464353238633237613636303231653638653662643538663865
63303930353932636438646139656265643462646531363763366363343335626663303338353839
37316532336539326666326231363763666332393438663663316262306566376438633634653434
38343762653966336462373839663534363936373834663230653838643733646334343337396134
31346564373236386466356265323964326536346232366233623932306630313565383931633439
64333661303266623635623638393834643233326164613730376438626561633238353834333864
35333165653261336662333831346132366634393136393538613330653835613164393465633865
34343539663637366663613562646637376266353736386162666130653233656538623061303939
32323435616638336438366437306535613861343464373631373839323865363930333431376337
61303965323732383534646162373665623030313938306262663235666564613634353862363033
39646538326132386465306135343665373561636330613764363538653266303364373261306237
65656438356136623933356331636561653863316561333861356635353332306639326165393934
39656464336538316536346565623039633132333031643164313264666336613034303131373461
30313037303461646265646662633938656138333337633463313630663330653762653237383663
36633861633465376235303561636533636266633336666561613539303264346536373963383031
30336165646363333761393864376236356439343661313233613661663935353066316431393131
30623330346336336466306663366463323761653539313435316331366635343761353030303638
37383636306234373261336563653564313836353962373166333661613364616235363861346631
63626364393961303436393431366464343661616466373664316535356631633038623031643236
63623439303264343766623537373464306230613234656137313862356134613864346338623435
35313838396663653633356537393139646432616637613338623336393438383462626231336635
31626461306532613766326463353561613561663333373934633464633265653836616538303165
31343435343536363130373566623063623531623131663435653433393139343532626534326232
34326262346633666433313234666132656435663163313962663465643538623962303837646134
66653438666634323732343836376530666330313435373930363839643539333534643565386364
31313163636333656164316330613266396135623538653063356230636432326135376636383733
35316465326534326433316131333263303238613935306137646535643364346130323934386361
36303731653761393333343135363031666261623832346233363463666236363535633036653933
39633933643833376632393762633863356662336164336136643361643262313661326432326633
38353064623937313330373032613061613732366564373432373830393532313635646239663536
63306630636236333238303066353236366234653538313038323236636637633333363165346538
34666236343862326337613839336665346466613132373564316430303635346364653039653962
35383434616438623738656165323565663562363032383333613732346336623063316238633535
64643565363937343364363831636462633965396537366464623235363831363736363238656533
66373632323362653266646332613134633636646461663038373631373239376635626335316338
36653037373462656466663061323234323938376563613034663235626162663832323964623133
35353933613564333434643431346664646630366237303531373863396261643539363161643731
61323136656438306636666166323938376563646632653434346364363537666533623133343234
39373239343463366133333739636531336631353836316461313936336435326330393634346234
33336436393763636462363335313832326361656364323435613566353539393434376563353331
39366135376638336135353935383730643537636532383239633765313532313162623535643737
39633338393730303262306231633438656534633066343262356630663734663134633166323665
37363731656637376335343135336331313562326461643365323166383462336135633866623861
63613338663337396564623736343739373830646532663462626531373131356539393564303934
32336235646331336234313837363332356639356230616561393337613265623433643332653238
35653534643230626339656163393362626261373539383236386233363533366563346261653730
61633662663032363764383337316265613338336431366230633166366564336236383135333536
31303932663233303930303931396239663964306534666363353966323236363130636463656439
32346565353965343638363530656236623837353338313939376237313966383834376264383937
31653330636538666234616430643332666439393838636332363966316662333730313338343361
65633739643666633935373535613462303336633332326637313830353465646333396265333062
37396338613063363562613236616338613231643534383737656439373663613831343739346331
63613434393437353738653061643664303934626634323936396432383566396234306231306161
33613233376331386265326433393837376561623164326563613835613739346431336538306462
32313539353563333638306431396630373134376433363566376531633039326230323033646332
64623834313134366137636164326661336232376439306361353832626665316638343966343063
30363230623130646333666234396230373661333465396338373438343538363663326163663038
39666634303363356630613865646437333462633639643865623736356237343837336130353964
63313462323363343932613664353931646632646334343931393934373636303466323331323166
33373264306333366233356334666132626633333531653865366463343838666566643439366237
39313036623339626237383765303039346535336139336131633132366333646265383363613562
39346530663161656438623763366465373666663138663633623362333065343630363566363662
33626564653661386361663863653735656461393065386462623537613165383532316636333539
36626636643762666262353032383630633733346338373138303365333637346431663662326437
34623466636234616263323530623731646435646465353262656435636633363236396238643861
63646634353365303633323233656566633136633838646235386432363062396132383031636265
66356633373063643334353231313838353237626339343363386633386261646231316235636136
34633738326565363938616335303333626236336365386632636365643237383534353330623837
65373339663238663331373663363736643633656437353737376265313862363030343762613036
37396265656333356637316166356637633761393466636564353161303163396534616166613465
35646164663933616264643331616530653761303530353762353461363265343430323830393330
37653638386165626661376365326532303036323665613031343662376166656566666636316533
36336135643530613534313034336234343364373237386430366265343438333532656535393431
61656433656239383163383761643833613662386162636166663631643835346535663430343236
31363262613830343133613837353231653535343439623334376131323966353064323635333531
65643564333537616638313935363330643132376364366632363633376566643030353261626163
61376639383165633539336630363739613963613539326264643166626465336262643866373962
63393530353164346662393266326535346533663363336539393230363832313537356463656365
34623562383734383235383935353431353661373362613838346637363631333664653538393732
63613734623065323238623230376131313366323466373738663766333538343065636330396134
64663834386463363664303062303335636364343866353762613032663538653131636530316138
36626165333335633063643362656434393130363439623533336635646135383930306635306166
33633962336331313031383161336432313432646336663961623466346132613663633437386261
64333936393463643030323132666639336334366237663866663231613930303165666261336234
37616461363061633238656565613263373464356565383338646238666339303663326535376232
30666563626534326430616536363163636537336130383832346366376666636566346234303936
32343130646165386137326563326337373237346632383335313231383537383364303961623732
33333634656531653030323935613336303931313034663436656564656639656230643062636235
32373738666463613065323834396536306264353264623562666361316362633666376664623037
62646662366330343137323761346261356132303964653533626665656138616533326234633964
30643032656233323361316463313537343232383964366266313432346538336233373763653161
61343162303066373662353437626636643665323365343731613930643936336363633239376230
61386266656161663134393039383334393338343561383362396132663735356235323333613036
66643831373335343664666333336665316231626263356339336362373230383430316336343661
32616663373535356163356265373032333761393631383562346163626339636136653934303935
34396530363162313365663732343734353437343061303966313739363132353163366362323732
61613066663637623566316135626462633938663366383839623633643630393035333965346335
64303366383935626332353830363635356336383866313239373162313530386639386466323964
30643332643163666534393664366334663466333633313438386165643336646265643330346165
38633233626331386265663164633365306334393963636536303231333263623735316134616638
34346633353536383732313532396463303930386235643065396337643966306566666539613637
65346639646438623461623537643436356631313861636165363037643266326231623633633566
66633861616139306633626562373165333766353934386465613036383666353736363336393061
61626237316634383637633735623932383533306238343031616162656631626266313231666232
65616165633465363033393365666232313261626436326539313636343337333935663737313762
33373163663339643363613864643561323039643863336238326534616636323239326632356463
65613430323164323539333164323536623030663861656661623333326666386338393433323964
36313239393236653335383239623135633731636230303833353536333263626636336632323063
66363533366635623537663037356634333361326161363332383065363434376131316237373561
61333061323764623163643363326130623331366536306163323333363033366238343965383236
33353962636364373066633438386334386336373065613234313439626633363465613063313537
37363236383139623138666238383136376432656565326232373864316134333038666165376561
63643639313465346164633434666630656633633262326661633463343936386533303536386231
36333232353735373461376265363936303132313232373437633630333461613734643964656239
34613565373435633561366366333464656432343230346239383063643433326133663233316233
30623834366632613461386535646662636464363162343435666133373531303933643163663138
37396535316438633433326433663863383238636431303861336632633839626663383030623861
61306338393565336239346530326361316532623466346562333761636663663263323566326164
39313463313836373831373938646666613533666537373738623536623231373430613832613830
35353964303363386535343938306239303436393561306365376534346335636466616364366364
37613938333435393363376230356436306263663566623266343265376466386365663337303463
64626138303834623633323237313436353361333638363165363531383032363837643533363332
30326361646564623962636264663933643935623735356438633232613335313033326131396461
31323133616637666564623366646362333938393362396365306235366361663866643661333933
65323531303934616637313139343435313265633662616532663238333234646663306130363235
63386532643263313665366463313064343464363538396465393832383164366138356437306539
39373162386464376232303261396663346332613034346465306630306532333635386239633634
39313530363730653633633933663564366264323936616331656465383034636531633830363463
30383331666634646163353165343037323135313336653934626565333131373431663865356365
66333331613133613333636366633537386631353031666662376437363834393133636332333135
30666562386462373462366436366131613133643265306332623964616336636634313338623830
63646637326230356333366666353432616135656462656163366434656537643335303862633966
65393632653930656130623939333961383166363064353763376432666234643339353665343237
61353239653039623533663833613664326435303962326434393736326366646634656537303864
33626433643837663632343237393336616662633332333331633766376134663837353936333264
33626633336337616139613535303038366434633537636237383261316438353765666431373031
31643833326338616435376436666563303437626336333938613234333433336463393561636362
33343065356361356431323537303630336131616564343065363734376638636264333864316530
34346439626166616239633730326365336134313733613935393837303932383665643862333535
64373834343137303532393034383866646362313762393862343864613262333833356238303637
35383566333530316633393530326436373562373362653835386430313033653538646136356264
37336363363030393163376665326430353763663334393366666430663037306533366636616131
38326235376461663134393439323933396432303235316230363864393539633930366538343131
63646435353232393038373636333861653936333630656330306130663538313439623835353330
31343964636464333134336438386464326437346530313365336637323866666130306638393461
62376231626262303330363938626265396163356165346430336632373730313063646664623736
39653233633566343466306566626230633831323730363066333731306566653337633538313134
36623434643039373937346631626665393165323036346462303536383436306634303062326538
64356138396638663434353937323536343130383666393563373462613732346537363162363936
62663037303839393538613835306564663262313239383837643436356263613430353262653230
36663666376331616532316334366266363236303664306437366631626236303463336530333661
61666630336462343239343333363436643362653762306164306462383731353464633762656636
37393361353330633866626466666163386337303264326139616166643131376466646335356334
39353933396166363561636237626536353064656439363164386366396535663662336336323536
62623830613662356163343963303363663138666532326566363036613062396466313630383131
64303434373462623061623663343438363965653339353338303361363962643061383662333639
38316336366331653937636132333966306566666437343436623461666363393733663731353531
36373262663037666136346233633531326239356637316333626336623236386431363039333934
65383939346133643239393264333736643163373434353239363563373665363363326638393531
30356261643739613530326434396565663565616239386338653438663639666339636231613739
32636262316232653832363239383236343434383737383834653865626236626365656539383565
34616238616433373561636463646364346633623339616436653162613166636433346162383562
37333337656138313965323135323630306464393762343863326139623435633363303432383339
66313838386235323734303830363266653536643236343662306262646137663139313661313431
61326433316632346533306361643135346230363739316237316363613136336463656133373637
32313338663765653564356632663230633931636332346637376565313664393461343263326637
63313139613964383333396361396234613365343431626238313664626165393438313363633636
66316534366538343135333938386239393034636565643835373662626232636237326161646665
62366332326662386266393864373836333564653535313135303735633233623962626262623430
64326362333937656638653932373766333739343161616231646537383635323939653064346466
65353466333332626261306335323730373231393364666365353363363635353562313936303361
61303635346333373964393961376230323039363434336239613462306161323534643130393365
61383033313462663661313265366636313233643632336132653563663638313733626131313432
66393136313461323539613434373232623931336561666532316538643139653366336263386162
36396434396632373463373466333165383763356666623365663233393637663362616639613939
36356331333735356133303539666461346534303736313833326531316662616539303964393836
38616566386630343837663764333735653538326130366530373765646231323938623063616335
37653239386264613262393263383038363266616130343239333137343938343266386666313637
38356238656538313533653165303531656366636133356466376133313937633130333766643835
35363539373766376334376236386130356664373461353962633736366563323636666538643435
32613433373535633765653533333633333731336431336333366261636465353936373039616437
31633461396539366637356231343465303130366662663932336234303638643562626335393036
32613363376430303032626635363330613562633161633962613537356330323463323362373664
63393565633730356561306431633933366433636438636633663635363339386363353364643665
36323865333935333361623338393233363339376635623233383134366465613163303036306530
65653133653461663266326333653331666632663636396631343566656233623032363538303633
64636334626364306130656135366433383831636361653830643766366137356539303963613064
31663435383937663566656331666537633335363666656166643832616335336162313364643334
38333965363634303130333038313162643063383962363632373236376163623763336164613436
35376266386636343563653439653530316666386131376139356166336534393064376635386162
30393136386139623135613262393963323765316462663834383235316162623931396438303731
62336565313538623264343562663333393263663363346465366436393566326538346539666437
62376164626633323839643361623434643635313165656462613765646532373634333731306439
35613366643864323564653431303165656133373838336261303365326135646231323366616461
64366461643033393961303638643830613535326639373364326631653963376335343130326630
32363065333733643531303932663966303761313362313565346636613235313564636161646330
38356136646561636636326664663831613162316630303038623565623662303962316430383664
36336135393964333435626364616236303534653532346233386337623732316165303561316237
64383731313635663065636335373664623766313330333634666231396663626566313665393039
34353562386661373931666362626433383835393232313163333433333431663832373139623263
38646131666233326137393964303438326639656339303365623537643631656638333331636262
65613737346164376338613761303137356337353235653063306432326365366430383834316234
33393063353038396461363461363432303264626639353136393632633762303638376634326330
35386139663639353765373361663833323462613662353938393062656535343237663239393364
39393234393263383539393130393637346639366665363738343865316263653065613965353230
66373139653831313237313831346365376563643564323334326163653962616361333266623233
32653864366261316162343231373436613835643531336236363737393465643066376431363036
39653662633430316463646635633134646236666139383265323330663134323632323636666239
39326661396364363636636439356635336332373634353537666431633030333637313137316665
35323766373430373263653963313131646433626431633736333435396261363136623761346462
33336665336332623663646464326632313931636466613330323264626434316664333933383031
64633335393535376336346233343430336466613435613161613863323264333538336263323264
37313561623561623531613766636663323666363533326162633437326664633561333631653732
65303164623736623861303932626661366137386265656261363834363035666165393864616366
30343939356463386330666664323536303964616630393735393161306364353732386439336666
39343438373138303532656165396565663663396338643963393436636463616634316135326630
31373630616533363064623837383031373864373734666537343236613065386165386561323638
33343238663038346365336561393637383132653361363066363931646563363965613733376432
3137346330663366396535623662383261623836636236626632
