$ANSIBLE_VAULT;1.1;AES256
30313931633434663831663138613161643237306362323837373432363636383862376533383764
3139343562386535356235386232303761306162336236370a393831326336613935346633393930
64366164313636366334646161393938323837653432613635333765383031303063386363313632
3331633365353064620a356637303565636361356133303762663130653066366530333462386364
38303431643634363932626638313238366238343330383437326261306138336462356431643161
37613932376464313638316162313161336662613334373462643663363562643264653162323534
37623763393038393035613138376435626132373266396332343832643537363537643961623836
34663862636133393939643765316336356637353232333434373263356133616266653838646331
62303839346335343734386430623265366261623763323630386262623536613933306338383139
62623833356531623861636130373631633461633162653833626366656263636464386664623862
65336531303534356237633635343536353435396335303538366365323232393136663965623730
30356536346561663130316439613461386637373664363664353465613265623139633231633662
36353134613730393166626433623437653733383163623035653961336336396263333334336630
32303436636531316634396661623761336336303665363236336337616634623961383030613734
61393436373231323264343863626631353232303964613437323831626466383335363735626261
32323066366332303335366266366536643231346464353532303861336230366339363265633437
37386533613135313736383163663338363937323037353333636635356263303236376463376132
30393062653565313738653234333139343964363461653235376435383437323434626365666461
66626263376466663165313531633831336262646538363634353361643263663465663561393266
63323735356365346363663165363431656234373433643363383766346137356139336364313832
34353838663165323863383735356133376362303165666639303236383833386539316163356430
30343934636362323535313639346434643733633632356232343139323564353565653337663066
36396535336238323165653335656166383835626632633862316636313732666236613134633366
34363538336237666130373636373336393736313761613134326630396266373231303635383762
66633261323664366361386363343633636530376463653566383562663163306339366163653531
36653132366230313163363735323562353835643161626461653565376136383534333837636664
37613932643034653537373735613138323839363862623464373132393235656430636462343063
30386262646565356164396664326166313536666235303731383161383530646330313063613930
64356663663037613731636132343666383633363866613636626639323537333662393931653734
64386339653238356636633766666162636666636364366161303638346539393131313437626239
30363134666563393062363934383734383036383330353534633735646261316232316664316337
34656637373962396538613862326236653731306533363965616536373961343335376338643839
64653532613534333466353933366438636633333266363766313935663063323865396339656332
38613534333234353139656530353161613634303965656361643765396465383862373837343439
38616631636637303738333132376631626136646334393737313065373532643035646533623530
33366361663436656137373264663831316561383138346334303432653034623436393537623361
33393364393231616364396436336466303864646134303335633365386263393533613236343363
30643266373636306265623531636631383235333661623063353435383531623431663734333531
34383332306164303066636465386263346339626233373263386665313932383535313632336335
34303165383434303230396164373936316164643539383166666264623533303736303935343166
37323966316665316236376664326264303830316133373530376133333131653036393864666561
33663332313561323237373934363961636137323862633730663831303836336234363331303634
34346262653735633462613861343134636139343132626339623563346439393265326432376361
35376234306430616262386433363135623836666533313966626634663162316261336138633030
64313964316332626264633762313662306133306132666333646634383835376365633966376663
31313363643434393332343434643630653563306332643237343135363530363066376463363337
31326562653034633130303064653830323930623363663138353138623830623837666234386438
66656162363636313961366261376236663330336233336137646634643333633765373631353763
30326536653039633164633731626432633937393438343931323037613863316134313131303032
64383666643466646433643337353236303865636135336338663864303732313933623761313331
32363062623565646535643161326265633633356133656661613261353664313962326637613235
39326161383561343139366530326133656238376266363932323833636538313634336161373962
66376133383562323933373831343034316339313234353263336436323836383162653864393432
39626234623761653235663966373163313536343530373638396631633031383261313437353730
64666634346233396263303933303932343762653235346665373662343836346534383339343365
32613265303462613865363266323630356166626363303839646236386161333763616164656537
35666165646365383030613837353132306133316566313638353932386666643139313838666139
33636133366437386361376666393166306634376362303434663534643963353332363433643231
39666136356132396463333964346664656565333032626637326136613139326233346562386332
36373633656433363564316138613762313862613362303835356264393231373533306236316434
36663335366562643266623038656262363761306236313965653934636539386465313335626337
37316363303038323261373662613730386237653066373162646631636463346137616234663736
62333332643134623064343039333634366664636537636333663566616664303332646464343339
38313966383237356262663862633337313437633262623039313931323035366565363338623335
64343034666438633862373935643535623264633363346136303933396563613464313734376231
64363734323834313435363930613537626238663232616130343964343465313663366239383037
30373532663561633232326331396431633731626331643662633966386133346664623264356635
38393838333837313634333666383233343233643261303339336632306437326263613037396661
34363566396363323233656134326333626163646438313136613130636364636232356135653838
32626336323538383534383865393433313564623834383839666130353862663761666363313835
65633030303161393631303737303865346435613637626635343938333539663637343034356530
37313630303837656161633737346563316538373933653535376634396166663434376464376564
65316262313162363435653862313034313638316137616435653930396363623736663864336563
64333932633566363837353631333931373933343637623935666562386461633338383130313130
32326534336339663034366665303761656262646465306365396661353538643438346635343663
32336166366139656230373462333265333365653534323331383830393364346536656538386366
33373731646534356563306535663930353133373834303335333832623065623336333232666239
30313737616562633530303530383730613962316437653739346266336561366664303065616536
64383937616263333438363662663264666237653865373733326339313865613134393366633039
35623236333663393037356135306134343966303639616138353666336266643462323836383764
31373734613666303435623638656564613439613961633531666438373135366236653832643165
34316532656436313732363061333263343534343337613137333632366639326162346133663837
64333138666663313837613162386666373161386333343233386131633630633862376163353365
61373238663364313634646139613838653163366538663737303638333465323134633336626532
64363264343239373932343566363738646265306633393132343233386663336530666165613736
39383130353635633165613136353664623130636336393366366234643732343462303035303466
63316262656330386262386437353631306633666635316664306335363033623562363664653032
30366162666230373837386165323263383766663831663332396131303663393732356335643437
37333932643965643134333630373436323661306532326461313233303266623438303635306333
37343165353265373336376334373762383939343738353036313734616135653133306132653165
31316432623833326631336135356632333631313035373466353536643038616563396166356638
65303331343061396635613334333935323238333565313437356164343530313065633837376336
62666236613832396336653965333133346533633130666635313837323433303866666636373134
63353063383830303230366466386136373731303838613239353761363733393739386136363839
34636466633533353261623330326539316133356437313032666263386530383462303138386631
36666265663862343665633162313330643139323064656430363464666463306662383638623466
35626630383135343231383439343139323833356261623839396639373865623938633436323566
63396365373433666231313233333237333232303835393633663530643132643131396238643662
62353837396365323233323066663637633336633662643631656133373039373232633465303331
33306630326536333734376132353432353038346262623637326266373734393863346330313635
61313231663935373236303665373839666634343665643135666536636233383064653334393637
33323635393539306330393232303130326465346164323130613461633631646435656530613262
62316462363361376232623936333038393666353266393038393639316437613266373836363732
64393861313565343638356535333631373331643130613062326262653633363531323566313538
64323834653335376364313035376635353963386661616263323264386537396462356333646333
33306138313439336230633166643762306661376636613030376466363535646463643664636535
36393363313234333239323364373665613837336561386561623835323864316437636236343134
66396337633336636161386138343435613664643466386363323436386137616431343030383838
30663161326265383933373861343365656233366331303763323161306138663331353537623530
62613138623264383832656432373137636439393464326136376462303332326335663731316134
36613830643432323932353366383861363364313838373661616464623365336165643763326334
38646666343661633438633332653636396563356239336562643436333264336263616632313334
63303762623531393930636433313636306361373163616666663632393333366536333230366666
64363634643566363938633439326334366464393330323330626663393534333037346331313439
64363363623334356134313966396366383037313931653538636630613433653339643964613036
37373132616536333430303035333731646461356434343835373765336439313831333032626239
65623261316134646162313566316266343137343334313636653362326135336433376630363230
65393133613962393931653463353235353138626364373438646664336262363262346566373565
61386162373430626339303662616533636434386431646366663336303964636132626237316432
30366231326338396566633566663761383331366363393165323263653031333065616433333937
64353934616430396230626238656437656663666231366235313461623562306561383062353736
39383562623533616436333764333837633239643536376137616263613837613931363133346137
30616364383638393361353966346461623935396263383664333366303331366261363664663631
33646366303835616338343564346532393035303534666331313632666361646465353936316566
33333462663761666565323334363637363730353130333463363133333061346336323066326265
34313535643065636239653931653963393761333436346137623835353962343533653235313732
36396438363262656333653838623831356563346563663535636635373865353733346637323437
30626365366162636265353966663039373465333630633065636262663362353435313231396330
39396635623266613339663030356134623761303531653865363330333562623136623237623830
64613233363231386236396666623835356165373835653531323938323666646339306138383363
66633936376539376236313131343361363763316664626166343534616539333536663335633061
33616331323932393464633566616230613365663837333935386139616661343538613731356539
31323430636266336633373065646535313464353664363338663338336165373532316236343534
62643538373637666234396564303562313336643833373538353263616562396532613030336131
66663831326139653735313037613363636563666530333436613632323561343666323666373430
66336637326233316337663262393365363334303838376661633030346166363435633561613731
62353637643431373537653730653830373866613563656534373936363564656366366161326532
39626537626438666564383164303561353032316235366632306461346231363364633262386634
33633131636537663730363138653061656365303735643566363965393261626133643461626533
63633666393266396134303630646265326630613033373161366333333030623765363762363132
38623834633835613039356561363531653362646631613865363835643836303965376531333235
62356537663761663931383435353337316132323865653863626561396134333065346137633766
30373063623338323635383235313863646535323931643330653138356338363036363233346136
66663337323935383431383533366533383733646239663334383666636432636665393562303139
64323130663237346134633033343133366635396531376463643839383664666665336130626130
64353139656139353765326435613032356132336165646264316532303664663166356139303764
30613664353266653032303166393238626133393562613862643036653937346238383936393762
36616463363535633639396636323063363766653234333239393632346261363532633864323435
32613065323864363266636663363965336663346235396266326164653435393033363932633064
35323438396565313139343161356631366564353631613766626363636334633838663936396633
62323864373638643033626562633635663666633637633364646532346535383735663637646139
61646530323662306639326363623439646664613265386166613535613039356133386430386330
39303265333832373430376465626137376466373433383738653737323334626466666632303234
31386339373333383763643634363863616433373565393866613139356237623733663864313932
37396437643830613663633861356435663834343333333661396239353164656233643866353633
35643063663936356538306339363033613234313066353130653561303238363666616437386231
37353766363661656334343162313665653564363239306464363962313039636638333761333438
63623133373231633538626230613232653731646332356538343435313164366466323462623661
61663939656463616136316535303264306136323264356663333739646134373864353536643238
31316637393538373733386231336434663930333362363234313432376664353136323031613337
63356234366338373661306239346263363534306134643132373636323237643066663863373531
30316633353962626161613335633565616462376339613666343039663666616431643731303536
65653163663331343237653863333830666236626461343366613530313439656134363261376337
31666532353836373131616234326465656466663132303165343630323338343439326666666333
63366564323238666466633837636361663862333262313161343835343563363833656133386366
65626530363334303137396566376336626238383639626265643239396131323063353630393632
33613636633764303431646364333437653138303038393136363863303362303331303739306439
62383066643563366530333337656161313862316334383636393436663064333834383437623134
63396263303862613761383034623337386438643963323936366366323731386537396630613763
36343138363062356333663065663331376464613439616330386132303032343765643134316135
38343131616136373631373763396437626161386334376432623866396433383637303165323062
32396231633361343732393231636537313062396233636339396334646332666533646463306332
39313961396132383630343032383338353233323666346432613539323333326230613535336239
65366332623965643731616632303534393565666639353735373830653832343336316431373034
62653961633463653930343439353837396531346461383163343933313265313563656230623563
31346566393833366536633766616363346537383230396566663838363163656138656634666331
62616633383064626338343330613365626161313665346536353664653165333862383433316637
36306432663762613339623262393761653632303733663364306361333962616165636135613161
32366335636233313639653865343637643834666138313635663361386430303435636539303963
64666263656637363334623932333161373132343933313464383365343365633663313537666638
66616263366638373739333065613461396333333764373965623162313633313439376637653562
64633564633931376233643539323761343435333162656630633664363663633331646262303466
31343132373632626563336539393634326136616465376239376334616334616261663334313764
64663735663564343538623537636463343261313234636633613463383865616234663833376563
34636531336533383337393465623431393536323735633738313566636132303236333435373138
32313866383935353530613036366435376330386564613461613762313737326438663261633366
63303863353763333536386538653464613239313739656161313831323834306138373530663764
39623638633236626565626537663663336436613261656137303533356361306264306663643664
64303733633462386336343839343233383831366463383230393836313437656232383866623462
31636163346264646438386362653438623866623463356538303632306561613561633733666534
30323233343561346561626666333031643965323635323362353963613161326338373438353731
63343232623661353265346437383964326239306235393264663066326332316463386465663964
37313133356437343466363631613934633933343933663238386230356365376237346638336266
38633833626532396635313239646465386264393361333236643930643436333765393937633235
66316164333334616164373865646366386161383664393031383732393735353534316239633166
62303437633232323065613934363633333031633730613836346234363161613731356566656665
34396362393830353235333166373564353365336339636165613335393561313562323233626133
39306163366364653931336365623334376332656633633966306635356265333338653837306135
66623563306665306332396637333138626562613432363539343932366332383463626262396131
64323565333163663536653731383066663036613130353836353237326264636531316364376131
61373230373832323461623130386532646138393530313866316439343734643665336135353031
34303130646464393565646436656532663565366662316665393863373262666638373961626139
30633262663532373731666333373037373236366535343038616564613063306631633932643831
35323865353736366262633363373966613335623030313738666531346136373163346166653435
34633063383663353965333464633638313739356334303138376337623135643638316232313630
39363031393863623439663665633839353837333338333934656133393966643737666330636137
37393864626536623734356265666166313634333733613566326634626366613164393930323363
66653463633865326633656336393935623661356639653164376365353464373762346638366336
39613130376364343632353864303134373737303963323165333761623462366539356534383239
31313030396630316438373234386432656466343333323262626536303134653637353363613932
65386563323231306235366237333738353662346631653136393036636361663530346433663630
37316465653164643034353566643737343832333664393462343833646463333061346230386131
30653633323163643139616565363337333063323632346637613533313433366139333234653362
39343965373264396235363436333332336438316234383935613939373338643364313236366536
39343037353461383535656332326637363530316165343464613062303536653263373434623735
36373963366366326162613231313561613435346266643963356261626636646637316163623239
39303832313235353730326566313236373030393230626136343436376431383363323536653063
32336136343330653838653631386433383135303562343234386530386364616337326539343137
61316263316435646366636132666366653835303962666262373136316161303864346435363062
61326563663438643465633962333830303538386339363437303164323532313566363934613761
31363266383736393265313163633664393434303461316266383132393831363763333166396461
39396533613834316634373065376362633331643936333634393235616638663531666461346635
38653561633263363932363765656135393633363764636463323937613562333331663030383561
65303434303665333864653133303466636365393334393236623730666561633435336666313366
30303139623464353664323961346164326362353936633561313564396232383835616230313363
63333636356637623336363738613831343735636537636138386335646630643935336230316665
66636464366462373761336166346236346438653763346231653938656366313732643366353737
65373631663765386337353933663262346166376435393733633466343862636230626161613033
63346636336534633365646364626138346636363333306561383039616566643534656636366163
34396439323030353135343032333735303565313461383135663234366337613862363763303430
61336537313132626461326366343761323334613935633337343662393564643939646562643165
65333361316431303137323832373538646364386637343462666232643663333033366136353830
30643165376566613932666166633138333935333863626666396436646566623762653736373462
35353863313134316366316339383734333330393437396234353764356562653639633462303331
38373135313334633165323064633437356166656165633631646233383764653438323033346233
30323133363764633562323835303862356138616530356630326463616466656632393434393163
65353063366233326135323366383738336434663663633161633939356666663332376133346133
37343134643333346637666536343736643536396530663565333432653931636466383532326433
62626131333336643635363165366430616530333339323734663463376364353535376430333839
66306230666565323162636233343934343536623539666132323139653063316433303163323239
32393565336566346235346631306636633065386239323234353937383030393839643839333738
39386535646232653635613765306365383232633435613130383963356330613230396536376439
62343732653566623632626131313462366661623536663865353064633239616634383436323431
32396230656434393766316331666631326462313237333837343730613336666439613866323937
66623831666535643837303165393034323266613038353331323462656530336531376138356566
30373864633430383639303961303836666338623236353433613531336332393234383132353039
35303436616336343831393432653234316462613538303237663437376165393932633034313564
66383738376438666339393832303532646538393064303338633634373631373864396630666266
62393936336330336163626337353364386235633133333361363434323461323932663365643235
64393031303932636139663839333031366333343964383863303230383838643365366237373733
32356239636637383832333762633531346533303564363139333463613436323264633764616265
35386361346433363864663161346363383436323334316162383561313635633031623537366134
33346336663861653165316437653736656666666634643333643965386633396332383737343964
30396562626161616530343735646432633133323262363330363266366630663563373162356533
61393834663735623439393762303736326236633630666539376131356231356364373638373130
38303334326338356665623065313863356536353833643262336165303138383661366536636465
38366538343763313763303561656330313831626134316237386232646438323834363530393463
35383739323537383264333836633631633661633139366432663635326634663236623162386337
30623039623765386437343266373137633065626331336164343131373361323637376637393235
62356430343933373865343235303138393739386366306538623139616637343461306438346139
35356337663661373437333531373733353464633562343235396635306333356462653561343833
61633137623837386137666366333735303734363737303534343362616536353739613861616463
33663038623536666639663138323737623633303665316534613264363935643166633562623466
35323864306464646238343631636466323732343037316263376438323165343263393639663034
38626135653131333634323465313633643239373433333038616633646431653532386461636165
66653536326166653666306533343133366536363131333939356665333865656633336665353265
30366631326230336232663930323262313531353934393663346362646464353134356365363438
35356338663563633665383737623534396261356438303838373037353566393561643333636266
65336535656631616662653062643562316232626135646364636237353438383764623337323230
61643361633166343430386261336161373935303434633934323737356665626238393365336665
32656162653161613139633332646432643835623366623132303765636432366464383437343862
32386364393763363332646566643165393438623431366330383064336561633031613434613136
66386330353936343862303962346239336664303430356463323539303365393835393834656534
61323439353132376464363331656634646634646166343736386163643638333037666565623933
35343431643335343336333538666338363433373063316435646536623561633962643165346163
65633564613634386336653836303962663836346334303966613664326432353266316461653639
63383263373538323135356134343139646261356532323233656333353166626666373462356462
33326464333263633637666539363032303963653538383734383835613135376531343833353133
34326632643064306362393066643563356236366131343439663765626162643062366131663864
62323539396535653063313761366134366265373538386533613432356161373437323238663737
38633963636338623035623834383436653839623532613336386436323564393531663937376132
30306663353332316530316335343134646634353132353136613735326663613435633364363232
31323864306539663663373461653639353064626264396238666362623030333936343866653564
36623032626164326238636330303965356563633332376532306262663165323965333837646635
39653564306331653566626535613262633630373737383734303566383766326231363935333764
39656564666330653437633033316436383563333636613563336364666538336636653035646338
63643634643761343366373032326663643632633731343439383536306237323638613131306666
37313339363834663162333937316264393362386630376636353437326335303361343934653164
39383163363234626666633337626337636166326130376236663266616633653364633432353633
37646665376637653164653537333566346665646535333330363738313833616135633261636161
37636335636337366661316436343063316163383263613031353565616533353263333232356265
66643263353637316534613537666636363533383966323838393836336335633631613162323739
36343133373061393962653465373139666337616261366531373931623935393137646561633061
30316530323263306435623438616264363435356439396366383239626661316162666134383236
66303636383832386461623437383830386133313436396566363131393031333465333336326361
30376530363134336435343962316465343736323733663531623234323632623333343039303664
36623938633138333435396665343664303164316664616162373934323739663163333463313137
39363539383063383130633532383737386264386366643231373037326163373437393037653361
64623539626262343061356666356139646331616665383762346362393064306233373461333337
64376534666437653434373639353134653864633666323333346336616563643838353433646532
65306134316130313462316437613436343165303936663533386638633962643430656530633964
30316537303463346332393862346238316566313866396335306637633839626334393561313235
64336338643330316564343134346634306435306536363963353237393861626230356366666262
62373833306531376364326539323131356138313763383032653461376135346230336166326161
39636263303836336637323337396130613565326338646139336632303438316533323837613962
65353633646139336466613762633863656662366633346661386534346165303061613866326534
39336266333534363038336631333231656134353937626138663765353731323634353434386562
32623664346330663466626435643737643431663732306239393635633434626664653466343931
39343131326363326466613437333032346531326162663963363337653230663065343639663037
33313934663131373532643132343534353033636538393463336537303566656538316139303632
61613863333464626161663439633238393230653262656132653336396464353437383034643866
66646337383264626266343463303538663135363862626337336533636263396533386336333338
37383735643163303735306165356336653961643737396331656335613234623334363261303835
64396431336438653963623130316232313330393965373336366364383632363831636662646638
38376336353437633432303363316563616364303632313966356261656566633961323333303338
66313764383738333033633265343137336132666536613931353465613733396563316662363065
35396565383464313934373836363035303365303732316638306234373030633239623730353732
35346136363937633931623636373836343864306561633461343861643431346437393662396639
65383766366662623130363163383961653730373632353663386437373533623963323566346435
64633861626230373137346238363562326234653138353131666534346236313464363033616462
39363133313130666163343037653332633134613539326639613366393562353639346461653361
65626430653338623835613236333962383363326139663536343236373665336139313930653136
64613336363736653762666634383739333731366562393563613232616238373565653435363363
36633766636636653437393834353139666432316437316338646664316363373430326435646262
63326261393135376165626365653932656664386235353937353831656238353463353166333332
34326561373039656462613534656266376331373731373062346463316463346265356562646464
656631303436393232383066613862356438
