$ANSIBLE_VAULT;1.1;AES256
64633430353139366433643161653363653839306564326165323364656566396135623837653764
6232323630323635363365306363323730623037393238630a323165343038383935373333653331
38633138373662303330386362333037393131333738366238636364316462323634346239663866
3961646631633564640a333336313334383764353261353134383961663833633963616563663939
36356637343530306163346664346662373865346133326532646335373464396261386136353537
3763633531323865613639616333663166386231663731633536
