$ANSIBLE_VAULT;1.1;AES256
62633531353464343761623562626533346130623233663734643135633933316564383936366134
3538626331346531623162393764313935326166613233300a613733336138636138306632313031
62343363363837333231373062656664636166373234393665373561353166366638386463623237
3066353564613237300a666366663739396261373432363535343133613434393531366636636639
31656531336234323465356434636661333733383539303762366161313533663331616361646335
30616230376162316237343762343061386432643866396361346534653337396666346566333931
35633562633333323664313736376634363663623134323163386362303631306137646361313339
37643363646538356261616138613364333634306131353766663730306662633262303637366232
61363335363166346232353237663162386664376232386666346365616236643331356163663365
30313663666662653136353739336531323039343738326535323966656535366165653432623433
66626161663735633236333539636331663131393537393830366535613336306330353134396662
39323032323165363862623765363764326434366538326434333232613063613530613330343934
36613566393430363639316165663539343730653730643832633836663930366439336566633639
31346162366439633738376539656334346137363133313865386536616363613231623465383739
30326132386637656566346264313665393839353530353831626532343130343864376365643032
35653437343661313932623534666634383462663338653932656337626235626566633638306364
32326238616337393464643236396131303238323538366634383837396534323632373863333831
37656134373733383932313461376163626632386130646438656534663535303363306530323963
30346166383363303263313133306630316634366639376361616562363237396563326135663864
66383132363335663833653564326263623362373033623762623163633364613632326165313566
65306535616230346433636236333165343662333239343238336631626463343231656434663930
35303666353363306164653435616436353130633736303234346532306537303737383464323933
35613364383763316262643566396331616636663964653765323431633739656565636238633833
39333639613835383962643030646337623439336336313034656632313338643966623631646137
31626463386439663033303632653962363430323265623930316263316437313139656438383532
31336264623062646564646665393737313232303331383262396435656632656535366230626136
32343530316564383861656466303130346533313934346232303338613564376165343335343531
37366636353165366238383365343736316131666235363063626562653231363234343461386637
38663566366133633437356161313662383634316562663061633930373432633435613863393438
36626464653234326130353735373133663535646338393565386634373764333533316134396336
34353331323239366137623837643665326161643063316339303536373130626438643735343733
38666537336266376161313563623565613736363661653434343166323033366437306439336330
33383038653539653830666638303033646436316664613035343636633630663464373362396138
39326462666362656239393763643064383138353837363333613262656163326631663339356433
34626135633534373330366136653266373565373434393664363632313061373833326638363036
65663138393664323934613831343437363434373966346538653031623862346139396232383665
39616238343935646166323538653632313336306431633035353766333231356363326632363038
32626165626362656531633566336630623662366163626137626461323039353334653434393437
38386236336566313463623732663835616661316234363265656466393038313138666135353138
35623362666266663364336263616530646162353362303562306464353736393832366530393765
64666532326262343363303137353037363331393839393132633430343766343133626631303464
30326232653435323837303337363939313736633566666137353563613533303234326365663531
33326664343865396661336163613935643136613733646233343261653166386263646363386537
63393166336139643365646635383362363136363936636634633838303534663866643832343763
64636665343662383738366230613638626431646634633933636461383339653732346562653461
39373466323663666337643730323539636361373032393138393134653731363836633866343966
33343033653364326164353930666136653531346436353135386330663639616463323138663631
65623334343463356638656233313731323664623937666566383639666530663638366130316533
34306335333532326163303432663937326465623239396434643966366231613530353739633865
64343030636337623539303463333532643262383131663835393961616535343136646237363364
63396430326362613865353832363636626638383330333334633034633530336563316230303536
34373465343333616331376434636235353765663930613937313331363461653637313438303136
66393739623737373436383964613062313231356663356635333635336235343663613434363165
65373133623034653331376133633739303065636564636262333231393762386334633263653337
30363562363936383039306137633538643661663662326635613332636164633964303566323564
34366434393433666434663437656339373938346263373135383862623465383331613366316235
63306132633464373032373036326533323861626661383335356535643737613961663065646665
66633864323835653534383864623832383133653966643131376266346163393133346337666336
33653635353465613364356432303439373264346130363832626330366634616238313739363036
32636639353839303265353335383862663233346433306438313763646331646438633064623664
30646532396561663032346338346632386630343932383631633638636438373835343732313265
35643536363561376434643964383333643161306537613932623639366336616634356361613034
64336665636362643364386263663537316361313634383537636562336363353835633835306132
30386633363835663435633337383162333566303136316235653535343733356232396362306435
66313161663132626263666530376366393031343433646665663433653765386232306231353735
33633136396630386162656334303563643162626464643663383865663863663663376662623430
63386639666638366462646133323538336462373563303464333166613866396363643131333733
33626563303863616430653438393061653532623761373265353136366639636134383431643462
33663735316632303463666439613939363266333531636465633661613837356561363135333235
34656639343237373935396563653730373035313134626336343066393862613936376138383130
33393264653237376430383163346536303136656137613362643762396163616133643664383030
38383539366538326339356337356535383165383431646164333261613863386165386163343339
38636166323930363364656138653136353366363736383265373036326662353032653036353831
63346333666634663832626331383066396139666234366361393639323862376463626161636637
35363461313864643765616430653961663566333536393132373234353165316235313639396666
39323663313964373665353230323861326333393935353964653731313562376437663432386330
63326432336465623965396466383535653333376538333739616139626262633234343030646661
62626136356135346335393264656339663038646565623962303832646539613239363861633836
61323935666232323433316631646566626439633866323265333332303866346366623230633930
39356131383634643163346533343035376435393962383165386133323137383165663066343061
37356131623661396335646232376631303962623839343935373837303264386538323038646636
65646465356434323664396639633563313363396433646564373831393734646631623332636530
65623062326638613161396435393664323534626461646366376333353734633737323832323835
31643532643539303135373266323937393262623730363461663265343164366362643962386364
66666663336565633831373436303435623161636362323132616464633835393365623361623365
33376534653866626661316230623735656437646535376635393661363130366437303462323431
32366431636238633036623038363166393363373635323361613232653064353038366165396664
65313738353830633637363732613362386564373863336237343530383665316535643961363265
32333131353566646230373138653235376636336636306537636663336333373861376431633862
34313165353133313731653239333834336334353032643136613730653864326137363866393966
39336539343865343161316461383137653666303761633264303634346235663238373632333764
63633065333134306661366333356538623034636231626662383664666630373066343236646137
33383636626136636330363465353038656462306466326466363536353838343832626166666464
64653339383838643133336264303465636239396361316537386436303333666634333134616166
39653863623036386265636464323363336233363031343762386234643362343466313064653633
64616434326139373831363937646362643533616131333963653831343463653865303337333738
39616262613539333233636366363035386665646433616636613335303261396263326332373166
65643634343937366131383766643063376236623730643365313035376636393662653831343538
33636661343039663939383931313937326434393333373934373061646265386235353332656530
38333634313739636137636562333565666431643438383137323330383638633263316638383337
36323333643366636237396266653064666437363633333734663866303364616633653262626338
32636333376463363739396136613038663161306230343463616635313566656635376239646663
31383763316261633539316661653931366436373434663237356435636431616639303937316237
63393433313461353330363637623032646634366330343833383635313263323163326536336561
65346431376337376230643434316565356631333430316664373533666238323666616536626266
32346536366261373830313636316565616561333438333230323265636261386534633835313833
32616136383235396537376232396539626663336635626432636439643832663934303065306433
36626135393738393062663265633839633962393236613836313465303437656561333861343230
35363766643330346131653462373037353034346434646161396161666363623036396431653731
65373062396163613639633631383132396234303233383134373830326139623036366138636536
37616232346531333763643831366333323666383066626362626338303632393664373838666465
61366664656638353432666161653333356534303831666432396238333266373761393465393433
30626262636232653333366262373930306463343930366461393635323037336166303765386565
61386461653265333233333737323139626566653464313063303333306439323163643439393763
62343536333031613262616161376338656237653961323639333531626232613133303134613530
65616634626535653736373639313433663838393937643365613336653232366263646431666363
62376464613437316431363439383931363433353434306666373264623133376334623934383633
66663636376234346462376335396533633932623164643230303166616465333365396561393766
34636530663963303166636361306430303062346664336337363664373061323061306438326330
39666433653231653766643332666561633433653062393234653436316661303732343038383863
35363736346562316662313836373739616464616231643264626463336538656166636332613639
30613837386532343138633835396662613238323232633263653238393563316561656264646338
31333139393762393161633462643561383235333539613334346538373161636166663039343966
33616665613038336662383463303238343838626535663464336333393236626531356661303933
37353730666166323735373830333362393035316134363131613431343138383939623335643436
36393831323966316565326438323964343733393634356466663664626531663139353733616661
66643061626338613861396433663635343062376639633461616462666663326136303161303031
38333561326165363664373161336439333266366138626663313036616263656666303234333536
65363838626261333934653236336136393533396634643630643533616264613662333930656633
36333439616536316538653566346139386366623663383730646435323233653134636535616435
64376236393331393635336335643461363161323961356333636366383135323837626165343239
36383361393265323036653064656362626163643662383835653966313432653561333464616433
30366232386134626337343966666139633263333136353938633561643334353866313265333566
64633964383839386162306564613166313939646438663337373531353665363661383834343961
33623232303938323433373431343632363832323865353132363631353765373034666437663239
38623664646363316135323132343035376135316230646336393638646432376139343939356239
66333739626532353034336365373666623139653164613039613765373139386333653863343139
35633533656234616637303034303137316166643061643739393865363162653066323734643333
32383634356534386363653037323566656666636131313266346663353466643537336630633237
66373131336134633938383961323432343632653538353938376332646662633765363730646635
61616638313138376533396230633535636561393235333864353930396164343238373039633239
39353932626662366635383162656332333762643665326534353661353831643662373536383366
33636265356132323462643834376465633934666461316330653136623135616232643638306132
64336133303239363066363436333539613533653331623136623563373035613835613463633565
34393132353034356264383136326332353164613230313231366166316365663933313533303765
65333331316231303633346639623466303135376333616661613864663138393262313564356366
37326337623935623532613033633231613162643335633337613330613337396436666636363936
39656434393137313463656535626161343136633065313435613563303934643639633236353738
30363231316362393865323065356561303161343034363433613965616631653133393637353138
32643639393765646461623433636131393862633861616666623037323364653035313734343335
35663631336437356136323134653762666135306232363730333430653230393038626333646431
65316431633066663963353433313539353532636332613234393635623138383834623637663133
66346464643031643736656439316331343664656239663933323233646264333130346434646533
62386331326232643133333934373531326333353634366565363634643162636639396435653561
32656338623434383965643265613739393935303261316335613266656531316564643762366237
32386261313263386537613033373962623261363535303065393430643162373739656233393837
32666266623533363833393231663535333164316531393339326461653463653563376266636331
31373433393639643834353039616162383631353266623538663666386535636561373833363966
39343963343936616335373662383735333238616630313461316564326538333035633830666665
65613033656335613933633534616561396637333763366331363165653837643261363337663236
36313831303239383862306236366637326134303732643036623862346330373765356264316665
32613664363766356364613837316538366235336435323535373865326438376636623362383565
33396461623436653266303635356562633534646462376361346332643365343862623261386566
38353261613935653961393135373731656635366362343962623639333834313162366464383830
65626234666232313235646430363130393331383466336431636366316232663831613639383239
64633231636537663361643335656532343164306264386337636430306636333064326339303636
61656238636436353766326536663366346662303038373939653339383830353065343066613563
65636231633331393834376666396437626231623835363765623062623431396364343961663837
64613033373333313930613235373734643964336565313837346338323235356132303735346135
63646663336539303735636536663464383664326438623264393236663664613233623838396465
64373631396437306339306234353637663938363438303464323535363965613433636566303338
65663331346166326362623138623936376636383563326436666262646463643734363164333463
64313363353162653537633832353762343362316238383730333836386163303362333236636463
32383831616134333661343961636237303562386462343964616533613864643735616236306134
36666536663531666230383762653236623730356131363730313333653164383163383134656538
30363365383633356662623734336536346132613539373232396565383035613664303933363561
37653630623330616565633131616330343064643337636635303535326565653137626464633266
32636637366561616132393131353463393363656239616639653461396135653230303732633062
64653766346531383833613466323965623663333132623465616532366164666563663666653734
36383064383861663363626434366136336338386263623039393730383733373164343434653163
34613134346662316234303633306534636331653866363932383965363730313632613965323538
37373836333736376133633861306238636364626264636637316234313237633562383962616537
61333838656162333039306239383265366564663638343536393365613134346637353136633735
66396534316266343761626430343231323630386539336663336237313634663034343561343437
38313832393035336239666232666331306663623433313465646663386661323937343532393630
34653365353865323636303835346633323965636665656231313365623138343136373437343237
32643332623238643563316330353334653962643332663932373066633238366135643963326236
30323131633938623538356435386231343636323438366434653433636664343738323662396530
39373638313065623639323434343364363431333139353132386638313832353762366263613563
62653066366632616663323131366239613866353234656463356630653865623163326630633038
35353233653261646532363164393435356565366363386566303362643633383937663430353430
64363461393938313366656331656565363734643131653231383862646664336466653437393732
65326135653930373662363838643566346466633061306634643062323231356535393161633936
37626666373632643864373234653365373636363136303265343064356333613264663561313566
62633234613837636337656233326436326635343430323361303465376162393665613532646661
37616639643362393565626163386561393435333662353233343636653663333664613264326263
32363235373339323532643931303761646633376564613032316630376461366364393637616165
65363866616530376336616536326230353366653539393261613935333138363262333939393066
63636239393938646530333130396166623864356366313563353430633365643736326162303862
35623863643765613035646463313931376565393661326562646366393036363263353563633233
30643564613063626561393036663434353932346664323037323631663835336638616533346664
63316461386631333136373162386134626531633037323234356635623162336432633135316662
64363737363633326231613561623133613461623430373239616233336464333161353639396530
38383933323838626233316466383361366133303537313538376436393662623230633163646539
33623165306362333366643361346464613063393762306339636236316138386338396464393433
62333532666338306233373461333236643436303762363365346233363463613562313566383130
61636164633865393930373032613337343766393139333164623763653434643833643365363733
65316365633865306431343934613338336466343331303036373365616439643932626138346665
63346233343566613961353038653862343639346532393934643164636637623030613135663436
62616663633461623537623665376136313236613736313637643530323133346532633230376335
65386162313135363635363838373032323362643265303836376361623233363832343934653232
61626536313030383337346165633836376633336135393563313334653335326563396130613536
32383366633433336233666531353630303734386338653332613965613131363663633331353364
36663864346561333937626636396463646137363033626130333538343464363132633339393162
31313539616432623238633330383864343135313834353832626632623935663930313366306563
64646532376433666161623735326361666166626561316166613065323465393230636163346132
32333432623836386138663332323263346239663361353236386366393035636434623733386432
39313763636532393061613435613662656433336132306362633837393735353465313633323431
30336332646466303439626439623765313961626635363138353031643664313934336361356364
64646337366531393031373936366233653932373134393537376633346237636631323537396233
36316561663039383531616464353630343938376164653939386566363866663539386134383865
65613237386134343030393132356463313936326235636531623339643136613632613232666130
38623034313961383564376464386636353239383035616331646536343562643861616661353138
38623134363864373032646163343737383038356633626166663635376464386135313436656337
32393535326133316662646339376162636631613835336431306164363236613730643937626639
39323031313465633239373262383539643534356430643330656665306438653139633532336266
33666663356163316336623333373231626464316366366235356136353134333064653333343230
64393266613035316162313833663364356633386131646362616331326665356536343538333135
66376462636566636462383266306530313561363161386336656637376436333334656239633331
62316164366638396335313863383237333163313463663764353563646137383335663562363333
34326162643865326431376635343362393437316137663132633766313137663162663239346538
38396430356536386336633232333762313130366665373530656230393564336339613664396431
31373034333739333561376237633464636631383266636664316432323766636231666661613164
32343963363366386537613762656433356230646265313262653336643362653032333930393062
39336363366430323366346633613662613162336662386334643638633436373366386332636539
31333233303562356263383333666362626665633836613032633234613430343633626566386630
63353639333666343835343936326434316135643833383339383165613864643766363039393638
61613164663662343166636639313032346537343639616664313636306333376233643331663866
39366363343365343836623136396637316330313333613438396462316139353064386263633039
34333635643862363732396132333739616234613138616363353638653566306566663833663162
62366131306162643063326630393765353565353961353366383032353666633838376139636233
31333562613537656366346131663566376332373761383039633064663532646230303632633263
34366361646436623832343833383961343136643639313236626662383033343534386364333937
33393230663464383838653635663039373737613564336233313939356334313731376463626239
31656466323235323331623633613861643738636537366462316632626264356238306336626664
33363565343737666437383135633839393661306266336235303830376536616161636366303434
37663964306636343534313132383561623333326134626165326264643166323064363965643363
33666166616266353566393362363137383266646365393037353537393839623437303066623464
64623163383831383036376662656638353963343933666435393834666664316362613135623933
30356164333933313064373536343462316563376139646335333961316134353032366264373562
65643636333163383463313037333137376165303634663561633432626339613266636431633464
61343632346539663533343839383338643966366236353333366264666662353566653738653139
61616539353934366530656231306530396338643630613362386431363735616562306232393465
39343639373231386464373432383036326437633033643831386165613530333761643437343661
33643533643362306364323939383165353066646138303561636266373431336338663730376262
65323364323530626136623438313231613965663331656431326164363266353139386138613863
65326139333535653835316237363532326236613130623162643231653832383732656666626566
37623466386331396631393934356262333535323563356133353966636135633338643838666565
38376533623963653839643036613863306533363333643661626239373062333936323665343162
38336363663665383862363666613533303465383235326131336131643634393662646239323665
36666438656533323463306639313035303831646464363734653964336238633564663838616239
38623664373137333565396662376431666564313630303035383335323266616237643463333166
65626133363639316566653162653830363132363766646163356664313433613337373163343637
66643031346431613562393232373833663663663737633837326135636232316337326534616433
61613664363965323737343934616330343165663766333832616366616236616364333965323032
62626264666661613062623137653430383661353530306530653430653030386131643863663133
35306566306435653137386335343130343831373130383763636635373931313262333365326563
62393931333336366365356132376234666561323663613633626433383634303937653533393337
38393031666566393232356637663963333535343664306437323664366137613231313133353637
66626566316265663235653562663966356266373638356463356231623763346163613732326365
35383637383762613064323064343133616336626235643338633566663138356563653334313161
31346630316236623834333561393362363566666631353536383536643934303361663065623865
61373465373535323464343766636461353335653435666431386439376539383234326530333264
31373564663637353164656334393861633562643266663064663632326535663933343036313230
32336637633037383238333536376630616461373035656430653636653062663835313230666433
34383433363032336236616133336661396463303661623532343865373830613338343864666532
35376533313537356137333930636435623935366430326237356561326231363237356632633365
32316237643938376530303837333231653761303234303538626430626530643137323365663934
62653637656561613736666631343765646164653737306231616231313661366435326364333635
65326663616163353630363163613338626533353731323262663762363430653063633364653834
66626566626432616336383230303934396634313234636237326162396535653332303263346536
37613964616462323038333032333963356662613465646635656166626566623363303634393566
31616237346330303865333732313262653136343263636461623539386366393638623132316632
33383536353332393936323831616535616437623935656464396537346432303263373534626163
66656636363565653537653335336234653265376437353734333637336435323664643166643032
36306432636463306339346365383536363838306665636433346638333731303662616331366430
30343161623561383935323031663566393833393863323466313730613139616233333739356636
31666135613466373362623166306130346638613365326131323135363264663033326566643230
65643733646166633334383231316530363364386465393336333839383866313832643465303363
35656335643430666265386533306430386135393065366463303661326365356237326637376635
65646565353162623566663661636162666636353033306233636234376162616337326533656664
32363637653266383534336135623765336266636538613935616134636336623561613331643130
35383433636638636466326135383465306431396436376537353565393166303439386634653564
65353366316536376532343338363765366338363633363534666436383761623461616539623432
36313733393431333838653334363564383235633436356630303065616633663830393135663837
65323761303366373337383232616464646666363538396331646265383538323766316531613333
30366636393236643037613838376262636236636535333566373761356634353764343835316564
32396139343339303962343533396132396538643964646461326630623438373435633438303636
34363333303166303861356666653664313966666238633135333165623862356634356538633365
65353434323433376364303339323464363334666462356136646530366462373235306633636563
62373764313039343135386135366231386264376534313835333837623934643634343235313863
63376530393033613166353064336231653336333262346639613034303434656462616639616266
32396163336332636466613839376436643831323639616531616433623665366136613133663233
62653832323764336563336266633662303061653362626238353736386638613534626466336230
36393233313830396132616561633232356630323838643239346161316133656639636166373263
30303535333666666231666539316439363564353734343366363662306433346632653435643136
33333134313561353535313561366632333932643365313165633762343635626566376564666263
64633231616636383532363034393235623361326563333539623332343830366536366563356366
30343830316263363231616331633234343730333861653661623463386132666633353662323631
39613263623866393932653661376631396536333039663338326435646238386534353364373135
66663837633063373836643032646162396265363963333965383233633333383865653461326637
39333335633333626232313339313938613466646266393766306663623338333134356531333239
39393534313933613665376663346363363766313634383336376266633931366130393230623638
38383963363032323535396634633764393866616334396633633563383066656465613931366663
62323963386534383833343937313761653763656465393636333835633635333861363565663161
39383739646361373466666365383566643830393835393265393666396161366230643837326366
36353362343562643066313231383836383534383835396532623664343365653332313139313733
31633564303939303165386331663761313065363430653730643735323038366663386431323731
35336635373162306266386337646231373731396330313130623331373532616338663666373566
30343035346533656365373366313463393065383931366138623664313536626436363738303962
34313830393636636230303938303062313465393664316464363436366238623135383932323166
33653862363032386362346462313166656234343934366339363762313336373730666466313330
32623130616234613135343461663064323864353137626538613338643930333661396661643664
35376561333339616364613262613530306338326438306434653966663534633931376433623462
31313031393834646562393261613133353238663437346132333635666531663930306161316339
36366132376163336433613662386261643465366666353064653764303938383238326332343439
63323262313563643533373961636635373533383235393664383037653563396562363037353837
63616565346466313766663463353332666534636566366635343962376663666236313533663963
63303339396432393032383962366338646465643838643463633430353166623837616661646366
35663336383835643666616537366130353333656162616636366365363830663233366564643431
62666138333866336238363065303966333138373630353334613139643466623765396538323539
64616662663638626163313833333932646334623630663532633533643866306430663636363437
39346539616663386663376534636230383031326266306239633365383336316537353730373031
38663734323337393466666132346434383062346232396234646234393363333031353464376461
65616634643132383964643663353239376262623937316163623333613333373330326661393330
37306364383932373538633739393430336433386466623936373533303230303039646366326339
63623163373635333766663236653335366230663064323938313934636332316165396461333962
31383262336437303332323166373638393761356539343633653432663638383339666130336363
65383338623931636463346334663066396334333538353563353461653838613231356531636561
36373665636161363132316633356166653133633230366439656333343831353761653831386639
31653035343664393663386466636238393865326534343330333330653335323036663861306333
61383231653464313935346630373564383333333634313664353735373663626365313161333738
35393564653662663362306236343364643633643261343464626331343637623662366163323236
64653563323237666136313964666265663362303131626237393335366139323230626332363438
34626639343235316462333865386232393361616433366534393066646231343165303534323934
34373166623331396265343738613736643738656161313338373161303933303762613463376166
37376464616337663238636231323935366565626138323832636630666464363730303839636366
65326332326139303634383638376337643032343761373765353236323131376637633039386139
64633762393539383638376565653535666233373431326532666338616537613162346430323937
6531663238613134643339653732306338303732316462343736
