$ANSIBLE_VAULT;1.1;AES256
33363632326261646133316264383564373331666438623864326263326436303665653966616666
3362333263643964393139616239636534326638313039300a363037363965363532363536643334
36363736636464386565323131373963333432386234373165353336336537323965396230363131
3063663232303134650a646431336431376561306436343436656633366439633363653561366538
66373066663834626432663838656637646632626233393532393264336361313263386563333463
36653162653866623962316264316265366633653332343862393661313364623337666662393363
36306238633066363039626566616163333963366536363232353062326263373337333263643063
35306436636461623735663134633638353065353639303665656337356366633161326666633832
61646434653965343935643636613534663235336131643563306566613364333437616639323662
61313737613665313537303364366631306333663539363466383732333835366532303638373164
34376362666636633235343138626336303365613334613061343565663464663430663866633762
31356531666235393764343232393334326235613361386435343735646634666337363163653533
64383630366133346135626339326361326536386137346564353838333564326237303462313530
33306461336661396238633538663662313439656332613562643165666532656333633738643333
34643166373638353135306439326565666665366566303964336462326338646465373731393332
62393636363733316438653563336632396161363562626231633030343663666336303133353763
30346538366462393762303564383534376634646637303736383864623765643038396234313166
35616433316235666661396636306334643135383234363530623965666437333666636337656561
36323931323336363665343564663730393665343165613564396331343935393934643261316535
32336338616637323830346537666364336237633862623930323536376537333666346430663133
64376466393764646436653330363633623064653062646630383731663862313435306331643934
61656134613833636231616565623063646263383933636537633533333633653932336462396461
66363362613962373763306230366663623339306239656365643535383465323261636364646432
66333338313337393061343134393238356432333238373562373264333736313633666633623733
34356232396261653062643432633032343234383034643466653235633365383663623562623061
64313061643061646439373037646131366634363538643361303436643036383362373762333531
37646536306534383163666139306166663931623566343066333166333234363735313532623336
33653539646131323830386437643031316363623837356462323535336235313037636631313137
62383061303834653339333831643562353630373966316639316330383737373738356236376330
37303864633635656264343833333837306266633436633234303261343462376434653763373661
62633638323764666439383461366438613862346330646232663163656665366365343965393030
31653336316232366235653831383164383466316463666164363361643164333733643230343939
33303962643339333733356638636439323136666664396632656331343734353231636232326362
36303936316234653535356464303162656464656234333435396234633636313130663336396630
31653835353330616266336537343237343161333135636431646462393635353261343764333632
65336261386134353865363732646563653362366166343838363136323863386433326263346336
66343561633464366263633137343631396162623036623531343131613334623537363561663030
62396438663765636561303532353638303262386236326531353338623939306666353438343662
38303531333433653062316536636331393330656466316631616433633433356463396239323066
62356530333862656134616166323465353464373661613266616231656135616333383434373936
35306363343964343364633633336366666361353531346266343864626165616631356463393666
38336362376439626432646438306633333965383662356364396437623435623965643431643532
39623464393031633865383562666635313365646561343137336139393337636464613062386338
30343839333736636539306261623430353438613165626361623936633737353639363431633762
64393539396364623732333331386532363063386463383563646137616231306364353839383563
63373466386439343536356430666261646363356334653331373862386538393831353861656334
34613034356563343364633261616366616330393730326334346436653932663433376663386134
30653639303933616264633563626637613932386437343038663963623933623834633165363432
32306134326231613764653636383931373934353864323935326664646638636664396530336434
33336134383530313930313238366537633337613235366462313433333063356336373330313439
32373933623131623833373735353666363632373661306331626236393435353666313666656130
39353130343636623030356366613864383935336633366536386332643730343637393531383436
33646638656634323836353736636634333361656565663834326564653731376163343534626233
34666161363163323161613836383964663162613763373632663263613935313037363066386133
33313866313735663264313863333932353735353736313035653037383061383434646639383536
63393633383063303064363166396336373464636138653364666535366637613862336564373537
62303164363131643638653637313832356265343666383131393336353038383165326132653836
61616632633263383333366136376466353334336635386132646134383434336262396231396562
63656632616637373433376464653038656238613364626331616138386332633038313633633366
65623166333234336530323063303633643162343361646363633666616637663036633532643765
37383232643933663134333466393562386130333562666165616233626235393739363763393263
61656465616230656634623632653234356438356666653931366338643837666233363163383235
63616335376235326532336334383339333835343061363534653464313963663032343033303865
30353065366130303131363966613864333162653439363638313333326437313166396335323565
30306438646433653936373064386635383365623836646131343765323837663137613464656464
34636662343864343931313232383936653633646231346332366661336333613861386534623335
36656639343564613266386332303238343565656439363035353133633836303438626434363261
33326236656563363336653031343564356234343238646332633662383061366136636237303464
32343736643038643434393562313661363066663832373230303337663132373232373533616333
61393064353036353634323831653464376635613636376231613836333262653166326434313830
62613839313562616166383665366431333139656565346432396534353761653836303865353366
37636239653334373062343936353134373538383135373065613964353734616131626531653331
30626437636633376239313864366462316230386465616263363730653261383561333739396361
66623366356235333233653839653530633562613464613964623437303130313964313636376438
30646533393132643164656333616530316366656230353862646261346631623833346231666433
30363035376363393331616461663738383136323166636636343865376139613561303461646637
37643839383730346333353938656635376162626436646137313635613434343063613333663534
30363039656435633335363064313666633361303262666630353564366264663464346330326131
36623861366661333764653963653734343633346265373361383132613366633633383035663333
35303165356334633036363530336631393663656234666533373063383036666431636130383763
64623638393139366564393038623662626664383834336535643139333433386661333139393632
63623162636265306462666362616431663132363236373833623163333237303963333636313135
66323564613365303363633330323837353866346639383730626136353537343533636333633262
61663966383438623935343266646632303062623733383038316635653661666333616461386639
32306565343864343136346339653331353363393134316331346530636535383032363465383336
37633132383232386165306635623762316335336466333539616637356438373239316436383231
66353566636238643361646266613462356161653930346538323138643963306531613137643161
37613466646238336437313435646361653137613936383433333637363561323063373034306433
32373537353761333965366264653135653933623934386162323736643062346334656430373230
64313131343163303437616339393866386431613762643162386530343230626336323830366665
38396234353939346233373838656338356637346263353831616462323361303765613061333936
37323937633766623337646632313431626433613739633338323931356366633866326239616331
61356162336135633636613164653734313239623461363762366534373335336139346430333037
61636661383338613334616165666262323236376132323234313333363735363130393737383735
39623534646635393138303961353931643939653064643363363939353039373435306433616439
32363538396234613831306232633436373338303261363866346262653730313831316633653063
34616336316335303165303830393637333665666238396563366561663239643366363836653837
37353066666630386533363933616434363563653638646638383132643965633432326663383232
32306565323035643731306662646562376639393861333336633237333933333733313765333835
37353337316464326433316337396131663565336236383531653031356237356532326639653662
31303336613931333966613135656363616266326339313163666466396533323435396137653030
36633231656362366537313433666539356266653836613239393063323664333833393738326432
35633431373732363262363162313534323136613563336339326635373432396662393033666466
31653665633434363034323335393930373135633735653065613638663063646566643335346138
62613835376332303533393435366264336336376332383637373262343863633534366534363165
36373564396237663961393534663836313362623766623130626334363764343261346330663066
61313332343030343363646364656333333031616263386632613136656139633162323437396331
61643966656336356164343431306631363936383738613163393739353436643038383861343039
38326230396662636337636631366235613030363931373437363538653562643430383261303735
36636165313566343333346661333363333036613339363966323134656339303330393263316166
37363634666536346330616333323331623036626238643765333764383737303635313362636365
39376163323638663861633433646562323831386561643335653138643561643738333539363734
37343835623261646532613863333337643065336130353364386361616663316534656535396537
33333166636530613863343234316332376630303665653866613464613766306162356464393330
63393465316638666465393033343764643566366537636165616634346238326539323532383534
30346431323866366138306563613730316139383132306236303037633434343566303765616265
66636331656536623734353130663336643761653831386233346233613663623837396233633738
37313235386530366364613132636335623433626335626533393331316565616635383035396136
65396161616362333638323064393664313661646530303364343531373930343366393638613765
61663630653062313137656166313534333135623564363236336535303235633730653536626666
32303661633562373639636335613765333233373733346662656430653337366664643961626262
36373431653037363637666262313937663232343333306335323936393333373166303633346434
62333331353064613430626437366364356138383961353263663533343934636639646533343533
62366234316461626130666634393234653730366163656132356333376334663835646430356561
35333063363063353630376561356563373838626432333334346634323562623238376264313437
31353031316431353361396166666130363633623861663962366234303632313731303064323832
63343039396331386664373837366533666163666231396439306532333838303339636433623834
38303535633639633963336435303136373333613763346464353038333165636636633738376137
31356232326436663065363565623261613763626666353465303432666431333833306265333038
62626433393138353336383162653330303566343533313166643963393331373763376632386263
31623338376336363939633765666264643163396138393933343831663335373466366266643961
64386565613263343334633434666463366432383739333830396437396130323231326335616462
30303532343563376133353835663766396631383935623932653761383064323164356461613632
39373061663162386465326664333830653261633865383961626133663964613833373638376166
66313965303930306362653434333833356161343361363033363565666430336163666336613064
32313931633362343361306634386337303134336266333732333339373437306666326230623735
35346133323166313936323837346661303333353933343438653436656266386633626434306632
30626235356432613132346431616233316665373963313064396535363539373236626337396433
37666430336434663062633564656537363939663030636633313364633033653038663761363166
64356361393865656430333735646138643136653637343861326361323961303132316262653034
64363264373661623961326635613434383565393366313630643538343739653632346533666538
36333631316337656531303039353863333233643431373661333232636434306135373966333235
63363236353161623763366662366535633532303134663465353334653034333132626634366664
65363838626339643464356630363265616239313365653538333635643734653836626265373364
65373335343531663764313133373530316630393233346534306438373532363330396633356164
32626433656139363431353563663832323131363731666630333465646461653739633035663564
64633335343536333038623230366634383136326232666665623636663061666135316665623632
39366139666239383238366634616663303034393861383935633833623133356265656532383134
34626664663966653732306265656166376133366434313832376531306238633962663762626633
34633366393564656363653732363930373932313362633837323365626236356430353132373665
35306137343239643263653464336165646136386461613866636435363134346434663365333764
34396139363961353563356365333733666636376330326536346431356637396332303161393331
32613139363232623466643031646638373133323937393631333439356438656634643237353265
63313237353135653235626430323064613735663062666661343930626234363565383064663633
66313136643361383361303435626662383130366363666430376138363862373561646530303434
33386333383338643963396365303963666262363664306235336130643463376664333639316131
39633931393132626163343062313164656633653436653836626334626133323135343366343739
36396232623063663332393539636562396137303735646263636434363535613462306433346235
35393563656232363035616332646635353139366661396632373764643832306333383639356538
30366164316466353436313735306564666431613161653762623135356431303766643330626461
34316132643830323364656436393830363864346233643338303030653665666530383836363932
64656365303232353633383466616333386366613539613934616261613535346331356264396636
64626261613230333931666630636563353763653463613030626538313232623333376430646332
61313730383362386262383261356232353066616262323333643232396362333338613465666438
35626461383335626131303937303432306261653938333335323834306634616438306334363630
39613566663663666230343661626337363934363334336663306362613362303365303562383239
63333833326235656434323866373337663937393331326462353633656238353039666664343537
33376463366134643136656630393532393165393030303930353934633266616564306665663235
63643033663465653735663232343563613037326365376236333461303030383531326436396636
37383433323531353464316239386430663636623334663037633539643539383738643838313234
36316464333737636665323236656630363966633436613831313866666365396332656265363131
39653434363033353037316166343734376132643634313137303936376366373165303230396564
35656634663663623961356131373932646666346635363230333833646163333834303237303130
32363732303833613364323465366333303139663164663132666536306332396534366636383566
33666264633036376239343030633863653238376436656661303364663565313330613064626662
36393137313063636339656563366266313332383235376138363731326132636136373338653839
35346330313930363735363533643432643665366261616361356461363936343562363138666132
35323231323236623639383365376430616632353565636166393365343737373964323565393436
39363765356330633832313539633531366266303031363565373932306238356636346131353234
66356430653339646235333636323437353365616133393934366236636431383131623264356130
30396539646131646666386566643732623437636335646533343334653931393065383763373235
32353661303530346163303837613537313631656438626166643763326431653339346137366237
30633837303730316438383762623261356365383938353735653366363732356466323439323333
37396562313231633365353735643861643730613036346465663739663938383365373833316333
39666561353864313164353563303130653730386166353032623630346563633263383861396632
62663764303735393266636535386331346336353636663332393563323732643631306330356531
34313261626337613663303931326331653366326262393138306435373436646331363335343939
62333565333066663363643865363861626362363130373464333331653162643436333733636433
38643639643066373132656561323539396466343832396237663135626361393664303937373834
32323164643461376639386163316439616466633635383930636131383235313336346430313363
30396265326537343738636662373033346561626435666463633532353966373065383336376539
33353238366436653838396532373531313038333835646464316161613132373731633531343564
64343431366361303362643135383630383161316439336334623331343530633633643166383066
33333332623430346265366163356532366633356634656338346265343535356163343532366563
64626664353239663066333533313263613234636265306262336239643331303461656130633039
31356662666235306432653330393266663332313664666163373032336138303735653134393530
34333331363061306538653634663566353364353562383333336361636361316239613064663639
32353862356532343239643930383133306539643830656132623430353033306431373639316630
35663930346265346338626133633630623464386130396236363564383032376161633537373664
38356539393133653062613038303733656532323262663237376239353435393238363533663661
62613834623632303736326236373665343064353566636136373431613231363934663362386336
63376534323463653631356537613436346235363630643731623436376361393531663733396232
32373234663762623335356461386263306237393261326532636162633934303764333235666661
31653037643639363235643533623835636563373235616230303735346234636530343866636232
65323461316261326633656539346161313332623764643233633231353432373561306330396631
65626463316661616539386631346637613839663032666163313966333937643833396561656438
36393566353732616531326132633439643734373036626132666339393665313862643038353130
36353236366466616638316266356362636232633264396630396535313132383363663661623435
66666135653239313633303037623765646432346239383239653534343264316532383633383636
65643139353036393937383037363862633263303864643530306266393938303462356365623363
61613766316139643564633262336433383266316462626261346361313266636163663433373830
30623264633932306266393864306565636361346239376465663736613330306533373734663032
64353231383930383237323462363438316439326261653036346333616664653766386363353130
65346334643862646130633938386532616238323232393634643962653531333831663165336336
34616539653338373461653465333136323838323263303830383862623330303432343563366531
31393232313963656361393664313136326637323862356437643364373134353863616433643862
31656566303130623835633337336235643337353138633261663062313839383736393361363032
66303639363737393236326365323430663735393737326634313066343039396631653430396366
31616561393765316230653131623036333337643834363065653831326333373630663136626631
37346665356364396238653637306234326165633262306262633463313363333461613838316662
61366438353434643766633763623863653466303865616136646362393232373835643038363230
65653039373734363539303932336364666330303466623331326631356463363763336166383237
62373531616366326634653162346665636237643039373061303234336261616464326265323035
33383265663933623134643037323830386130666665363838626166326539323565383835326138
39356438373932366630326361666666323462653135366331313166393239666666653136393738
39383363656465353563393165653533643235343234396437623937626364396665313831646339
65353934663136663362626635386337383166376539376361346633633432386166323662363962
33306562393830376233373832623338623231313161316434303439613765663665303464663662
32393136623061636364353635646164366538323637363161333362376461333336363361313131
34666665356339373762393438313635353861353535383364363734383732383333316637633830
34663437373466306137343265643635393030613962363932663030393062316335636261303966
30666231326162666236346234643465663562616361313536356133626433393532303664666430
61643230363733323132373833366439663763363533376237616461393032383431646464323066
66326137373261666235333038646165656662393833316262333138386663303764313135336661
33363130396665646135356234393161653835393963643932323430303364303062333936626532
64356266623634316462666539393661333364313262386632646333623636613963396233386130
38386534646130356433333938353862383864366632346439393335613565366466303030636565
32366562363534373964363862306539623639373563643635386439656530663566633238613266
61613262396164303231356539346538646161663231613937356330623866343133343333356566
39306332383334383831336135623939623563653336323633316462313133363266623533313636
35373135643037366466336365323531636338373732326131333863366238616636383036633938
33393462303665383830356532643636383236353732333663666439643336303832343165373134
31326566346361373335336163323334616666383235626233643465313361303737376435326563
66363564363031633133623661373135613430343363313232653734323832363731396233356532
36343465396661626464313139303535336131366332616437636162303764303661363666333038
66666164356235623166616564353564316165343339353262366563643937326537363839623132
64646133336337373536613431333435613864616665333364396439396561353436656332626232
66383230393835363834363730303963363036663763666262666238666538646432643665333539
30316166363438323562616539343631386530373262333166633838383735363732316462356334
62333961623330646637643435333436623361393837363434666332343339353761336536653139
37323163316464646133333435373430373730326466656262653064373463633362616438306263
36383036366534656632663034336235323639333932623863323930396561316632353637396432
39666132623131396538626463613463326465666365346133303338633032343166386235633061
34316563396530653235633835323331633062333365653166313664633664393562643436336535
61636163633739626261323435353462653730373664313761613738303764306431333834643035
37653937623266643137616434323936316361656363343435396135643137656165323736656366
30386335306331643264336166373166363232363834303334653535313561653937633161636432
39303265376363326563303335633233396239313837313265633361353963333131613761653566
34623037326566316639383335663539346639343762316265323432326563393933383832316231
63343230653663316634353031663939333461316363396362663839356462313634373835313263
61356332333230626332346335306665306431356262626366303434343563376138383966636361
66653032313133656334626337376639633239356432363665663563356234396130643036336663
31303937636331353830356532356164613362353230373061333832623266626166393833356531
34343936313733323864396233303361313634333866306435343661346166316364386263313937
38346637643837303733343437383063646637656531663933333130303738316637326365646463
65613665353136633433636462666665326464616633393335303130623231623362316332616237
66306433623030396562386539646631643865326136613739346637323662623166353736333830
39613364393434643836646130616335633465313365356133393239323634323536663863346165
61366230623939393833626138323233396564633662313034366534633135623164636666663931
30396639336333623930653833366266303537393633316531633132303061373930663137303062
31356632663639656233393636633566396235353537383165376165366331353630366535373463
64613936393238623364653132326563346634343032336236663962303234326564633066626432
62643437376265333730656662653532643561346366633139656137616530656332383635336436
30346465633163663035363239336165313162383663633562363035323862613666333230373231
65616434333461376265643763656366393938316262333635356132343634383364326461326534
64643262363936386335303461653534306565643663616334353566643131356639643034363838
61373961623230353535313132616462396139353833646537616635323139626633306231363037
39386161346564656561646438306361346336613261623664363066643937326533383366313138
64336163656665343939653634363161383635313261646639346436656466613438396461386133
38666330663333613636326166363239356364666261633761383637356562636134326231373037
30303633366435656338363763353437363661396361306163363532363565336232313734663937
33353065613533663233323266623133366364313166326563613237653266656666343730353033
62306266633762333431356136633131663065316665333332636637313337633935373136376666
34633330366162303136616464373761353665343737653937633161666231313237303661646134
61333166313238356162353930343162623365336665326165636234393564316164356138336438
62353430363063323337303937616566393866383738626230333132663565363763646332393630
37653138363337346131383133356535623339643230613734663831303838613334643838366636
61613235323663303936663465333361323138343964316339303266396638653537653538316139
63353331643933323565656163393462646432653062653234353739666563643663356631666436
63623036373138656161656534376538343434643563636162316465383037396365326161633130
32323839666230323737363733343863353335636534653133636235306630303837336463356531
61303439663566663736646132396162386162363136343232633330636632373264333866353763
65313330303735363864653739336639613539396338363366633336386631656435306134303538
61353831626631316236326130326238333337336632643561303362633431366663623539343838
32363465346236363336633761623966333131373233666261383032356461323265613934373461
63353132643835653135373965623932353331313264343762646633393561613432336330623831
30363162646662643733616162316539373965306462363665633739376530623632633235343462
63306134613964613931373536373737653361363134333833353338623835333035383566393033
35653565373666333561653737393366356534303431376431306531616566303463636263366431
37373836613766336461613833353330326234326534356562373639386130376664333734313437
38323039323530616361356137653437623939623731343434366465653734623933303336373163
32643164666261633635353663613666306564663732333962633336346236303862323064323664
31303662653233386130343965613963653632646635396131623561313064373435346362356565
63366265313966306634646161303837633839316134386262613034653638333132613561643836
35336165653661663533366335373664376332356137323934323634636136353836643531633561
38346239326236316138376362336162626661333565356661623463323130373462613933393465
31623930663334333465613830396433306539313464653534646437626630653530353364373165
65656435633137656264353766373565666333346534386133643634653337323334336533666562
30653834333138643430656539333237356535633965633538376334353161313865336362306563
37633062396131386431316266363163393935373639333234316536643736656530626336636335
39353739336264663630633161346437613037343963343263333239383462666634353531663266
38343239393765316136343339663832613062323963623437323434666138363133306238363662
64393264643931323033376133613430386133666666353136663965616464623963396631666465
36386238306531316563623234626632623833326632383663363939313665336535623734393866
37643532363731396139383061666664373562303937616139636236376263306637393537313230
31326366623234613536656663663139356566356161386662663665656139353239383465626562
61353561633639663236353432313231313965393365653239633965663937353864393038326562
37613561383033396265363532386465343636393033613762616534633662323831396265303936
32326236666163636639306431363664623530386231653835303732383365373234356365303237
32303165326137303264393461643534613936313862633363643265623634323539633337366137
34613034343630336462346231323866323963656663386166393338633061653866313932613634
61343538383036613161376266313963343062616362646430306565313065623034313366616237
35633234383238623936643432623563306561333665656139323830363639356535616165313339
33613537316262623636393665376537323838383935323234373534363536393431303862353962
65633865646165633637303837663737303066356164663338373861383530366461323035333531
31613535306535303035306666363533393864343561643364333261343936646438623938323964
37363064386262383935383731653738343266396461373233383431316630646536663062373630
31393737646638623862373030383833616365666632303766653566306364333966323963613830
30353466363566613166646565333932626462306166396238303963316164653339346236386538
66613437343934366533663036393966613035376666373935353164613330306463623464346139
65393033346330343864383235643437393661623331613532336133623131333239386134633532
64393461343865343836373938323462343539616665633938323861373031383734373332636632
63306136636531393636303339623261353333313237353631363262643837656632643935363432
64643161326363353037356163366636326137396639303461626537323834366466366130333962
61666139386536393334613765636561346236373334353638376630313533396366643439383131
30343239616338366139346663636232313331343234303530643730343261306665396336353861
32343234353630316463303631343833316432633336303631613164353533663561336533663633
62613362343066336563313530656137326265373239366430373131656362356438633337336137
32613337323762356536653961376335613638643662663361326131346361373363366438383761
32393333656363633437356264353535306135376365356636353431346366383834636565616339
37353231376433646636396538306336646438303839643633343537616561646435333439663636
65636336653330336631313431653262363061646432356663353633613366643364383466626461
39303262383130376139363539313337343330623835613831646563323062376139653166316531
30646364356230636263316261343136666565383533626235653164383930333234626664643661
33313034386239376438353935656338373233646232366239383266353336643036316531313632
37323764373637316366353063316362663165356163646635646566333331376535363035636664
33336338376631623463333437353561393338353463356238376139666363363930376432626465
62306662386264303134626566313234373239633764336166393162316265333965643336613835
39623636383562363934663965363762613532643665353534643938343730373362353931356262
3161343739373166353138343035643032353437623334316466
