$ANSIBLE_VAULT;1.1;AES256
30386531346239383466616438353963343334323033323837366236646432613130386434376139
3937383938306135333563346562393865613134663133610a386439656261633361643730313335
32363139366561623363646263636436313463303836396530353562643032626634363036323733
6535323535613534330a633237333832616566333464333935313265653338343365383730666532
61313936313964623162343330613039326134373636633133616233326635623831633663363637
31623336353736623265366534386436613039316463313236643936343764666136373734383661
31306161656164653365373539383334323139323861383762313239633836383530316264383863
32336232383863336666666138336538396461663462343537326533303738343965616531386633
66343831623136376465373433303765383134386263373737316464646364663035343563326431
65616462336264643232323964303832353264333231326238393566333437316361313337383933
61663761373961653832383732653231336663386165623237313036353931636537363636343430
39386331336666616232636236613033623033666138346437303238393863333630386565323234
63336532663036343266366562633234366133636137666437633834663535623365306330623630
33376136363931346335366138356331333133386438366161306337636432636633383563316339
63303662366262316662653136316532326436363661336535373464623835666366643064326633
30623762613637373631
