$ANSIBLE_VAULT;1.1;AES256
63643332336537626233373531353932666562396435306662323265336166333463353061383062
6330643832336136396362656533383933326535663266310a333438343330393362616231643738
32346463643761356435666233663463623362396565656133643733346562303466386533313439
6330326237653733300a343937336463643032353961363664623730336338613662396436313130
34366463353530373132323137303033613234613839333239363832663665336663646566313561
30643231623162346261383239316532653539333963343163396261653664313762313735666161
39336334376334323131333531646230666434303665613834393230313961663063373266666365
62393134323664336162376331623463313439653262366562303661653535376465323636376664
32366463396464353235353466333030396332323535616265616638613561353635663334336266
36316661653366313035663838346630353332346630333965363734363261386666393065313231
36336162343362346364303863303335313937376162643338646539343330333032373434356532
66313036616235653933303865613161393364373830363432646364383038633139313739613030
33613363366637646639333464653030643439363565633834333734353130623133336530333137
38646135356537343161396364383261366438313933383363366335323138343436393233366661
653531633034613039366461326130373139
