$ANSIBLE_VAULT;1.1;AES256
63343164346539623637623464323635326261303936373933396635326263353366366666353864
3531343463303233376330643435396566353632616666660a346462343166616263306538666663
34633430356338636266363236353034663863363336313131616434386136646232366530393661
3564376330373833640a326162316161303334636238353663633138666239396532653562373831
32663861346163633339313939336636346439343639366263353163323737376130313830346139
35616431616661653436373261366231386636363262333666316133656635313766656637346532
65383530383734396462366462663965623331646431666136313937303234393664353861646533
63383764323361643865646230313131343732373761656431383633363631663334326531666130
31306434623031633030336134363336383162623332613330313062366465306361393961643133
35363233316632336566383733663263363436323332336238663538616231373230663232356436
61386137373336653364323539353763346230346463363733653363366665623933376565306335
34313034666332623134303436653236323866313338613833613239343261323362303338306163
32343338323461633066363165343232316132653533336337313064373762656136336365636364
36333266646631643938393239326232386134383434396636383263643038633431623435313832
646438386162303139616561356565643831
